---config@码表分类=辅码码表
---config@码表别名= 二重简码
䒢	agc
䩕	agg
㭿	agme
䭺	agmj
䀚	ago
㼜	agy
岇	ahee
骯	ahg
枊	ahm
枊	ahme
昻	ahoe
醠	ahym
鱫	aiaw
㤅	aiax
㾢	aibr
皧	aiby
鴱	aich
薆	aicw
溾	aidg
濭	aidm
嵦	aiea
敳	aiew
㢊	aigk
䅬	aihm
馤	aihv
鑀	aijw
鎄	aijy
啀	aikt
娾	aint
娭	ainu
䑂	aiob
賹	aiom
䝽	aiot
䀳	aiou
瞹	aiow
昹	aioy
伌	airv
僾	airw
㝶	aisc
塧	aitm
堨	aitv
㘷	aitx
磑	aiua
硋	aiur
䶣	aiva
懝	aixr
懓	aixw
靉	aiyw
痷	anbd
䢿	anbe
鞌	anbg
萻	anc
葊	ancc
蓭	ancd
荌	ancn
屽	aneg
峖	anen
隌	aneo
揞	anfo
厈	ani
㱘	aniv
錌	anjg
䬓	anjo
啽	ankc
咹	ankn
鶕	anln
䮗	anmg
媕	annc
㛺	anno
㜝	anny
晻	anod
腤	anoo
裺	anp
儑	anrh
侒	anrn
韽	anro
罯	ans
堓	antg
豻	anvg
玵	anwg
㞄	anyd
雸	anyg
䦋	aoaw
镺	aoay
翶	aobx
芺	aoc
蔜	aocw
澚	aodv
滶	aodw
䫜	aoeb
㠗	aoed
岰	aoel
隞	aoew
䫨	aofb
擙	aofd
㩠	aofh
謷	aofk
嫯	aofn
摮	aofu
抝	aofv
㥿	aofx
扷	aofy
䯠	aogm
熝	aoh
爊	aohh
軪	aoil
厫	aoiw
㕭	aoky
柪	aom
梎	aomb
䮯	aomw
㜩	aond
㜜	aonw
䐿	aoo
嶴	aope
䴈	aopn
獓	aoq
㑃	aorl
垇	aota
墺	aotd
㘬	aots
㘭	aotv
磝	aouw
㿰	aowy
慠	aoxw
㤇	aoxy
䜒	aoyd
謸	aoyw
䭹	agme
䇦	agvy
㿄	aiby
䔽	aicv
凒	aida
溰	aida
㱯	aida
敱	aiey
㶼	aihu
㕌	aiic
銰	aijx
嘊	aikt
㗒	aiky
騃	aimu
壒	aitm
躷	aiun
䠹	aiur
餲	aiuv
譺	aiyr
譪	aiyv
䨠	aiyv
鮟	anan
䅁	anbh
䀂	anbm
洝	andn
㟁	aneg
䯥	angh
馣	anhd
䅖	anhd
闇	anmo
㸩	anng
㫨	anon
盫	anrm
㽢	antd
貋	anvg
䜙	anyh
誝	anyk
㠂	aoew
㟼	aoew
嗸	aofk
鷔	aofn
䵅	aofw
䥝	aojb
𢣏	aixm
𩽾	ana_
宝	bc
鮁	baad
魞	baar
茇	bacy
夿	badb
峇	baek
抜	bafy
弝	bagb
䩻	bagm
䆉	bahb
炦	bahd
炦	bahy
軷	baid
颰	bajd
鼥	bajy
哱	bakz
䎬	bals
欛	bamo
柭	bamy
㔜	bapl
叐	bapy
仈	bar
釟	barb
垻	batb
䳊	baun
䃻	bauo
犮	bauy
癹	bavy
玐	bawb
㺴	bawq
覇	baxo
詙	bayd
跁	bazb
䟦	bazy
鬂	bbab
䨈	bbbf
䧬	bbeb
虨	bbhp
䐔	bboc
氞	bbqb
砏	bbud
瑸	bbwb
㻞	bbwc
霦	bbyp
虣	bcaj
勽	bcbr
窇	bcbs
嫑	bcby
苞	bcc
菢	bccs
宀	bcdv
报	bcf
铇	bcjs
闁	bcmm
䭸	bcmx
䳈	bcns
曓	bcob
㫧	bcom
㿺	bcoy
勹	bcpv
賲	bcrb
䳰	bcrn
儤	bcru
緥	bcsm
㙸	bctf
堢	bctm
䭋	bcum
龅	bcvb
鳵	bcvn
䈏	bcvt
㻄	bcwr
䨔	bcyw
㿟	bdbb
䒔	bdcb
㠔	bdeu
拝	bdfl
挀	bdfn
㗑	bdkf
栢	bdmb
贁	bdow
襬	bdpb
絔	bdsb
㔥	bdsl
掰	bdu
兡	bdub
瓸	bdwb
䢙	bdzb
㮺	bfbk
翉	bfbx
泍	bfdb
捹	bffc
撪	bffl
㨧	bfft
㡷	bfgb
輽	bfit
㮥	bfmt
桳	bfmu
奙	bfsd
䬱	bfub
逩	bfzc
痭	bgbo
菶	bgcl
奟	bgdo
嵭	bgef
䳞	bgfn
䩬	bggl
䭰	bghl
嗙	bgkf
閍	bgmf
䙀	bgpo
㑟	bgrb
伻	bgrp
䋽	bgsc
絣	bgsk
綳	bgso
埄	bgtf
埲	bgtl
塴	bgto
䑫	bgvk
琣	bgwk
䨜	bgyo
逬	bgzg
跰	bgzk
䰷	bhaf
䧛	bhe
捠	bhfb
幚	bhfj
䩷	bhgf
稖	bhhk
䎧	bhlk
牓	bhpf
縍	bhsf
㙃	bhtb
垹	bhte
幇	bhtj
埲	bhtl
㨍	bhtu
彭	bhup
艕	bhvf
㿶	bhwy
駜	biab
鶝	biah
鰏	biat
豍	biau
髲	biay
粊	bibm
荜	bic
䕗	bicl
薜	bicx
滗	bid
䨆	bidf
湢	bidt
䎵	bieb
聛	bieu
䧗	biew
㧙	bifb
鄪	bife
鵖	bign
㢰	bigy
煏	biht
螕	biib
蜌	biit
鏎	bije
鐴	biju
㪤	bijw
鄙	bik
啚	bikk
朼	bimb
驆	bime
楅	bimt
閇	bimx
柀	bimy
嬶	binc
嬶	binl
睥	bio
䀣	biob
胇	biof
睤	biol
腷	biot
䁹	biou
貱	bioy
襅	bipe
襣	bipl
㪏	bipy
偪	birt
佊	biry
䋔	bisp
㘩	bitb
襞	biu
饆	biue
舭	biv
㻫	biwe
幤	bixj
畁	biyl
跸	biz
䟤	bizb
魬	bjay
秚	bjhb
蝂	bjiy
昄	bjo
朌	bjod
坢	bjtb
舨	bjv
斒	bjwc
鮩	bkak
苪	bkcb
䔊	bkck
疒	bkda
陃	bkeb
㨀	bkfn
掤	bkfo
棅	bkmn
栤	bkmu
昞	bkob
鋲	bkrb
仒	bkrd
倂	bkrg
偋	bkrk
傡	bkrl
垪	bktb
垪	bktk
餠	bkug
鯿	bmac
鯾	bmag
窆	bmbf
峅	bmec
揙	bmfc
炞	bmhb
㲢	bmhm
鍽	bmjc
䁵	bmoy
釆	bmpm
猵	bmqc
䪻	bmsb
鴘	bmsn
䟍	bmtf
碥	bmu
㺹	bmwc
惼	bmxc
覍	bmxe
辩	bmy
邉	bmzk
髟	bnap
䔸	bncq
滮	bndp
㟽	bne
㠒	bned
飚	bnf
䞄	bnfb
麃	bngh
飊	bnhi
贆	bnkq
㯹	bnmc
檦	bnmd
臕	bnoh
䁭	bnoq
爂	bnph
褾	bnpx
猋	bnqq
墂	bntx
謤	bnwx
諘	bnwy
䙳	bnxh
鮊	boab
䰊	boac
駮	boax
驋	boay
苩	bocb
葧	bocl
蘗	bocm
淿	bodj
殕	bodk
碆	bodu
㴾	bodw
㟑	boez
挬	bofz
髆	bogc
䯋	bogd
髉	bogf
瓟	bogs
㼎	bogx
䭯	bohi
䵗	boht
㶿	bohz
䗚	boic
蚾	boiy
钵	boj
鋍	bojz
㗘	bokc
䪬	bolz
驳	bom
柭	bomd
䮀	boms
袰	bomy
䳁	bond
犦	bonu
㹀	bonz
胉	boob
㬍	booc
䑈	boom
㬧	boox
袯	bop
牔	bopc
袚	bopd
襮	bopu
襏	bopy
狛	boqb
猼	boqc
犻	boql
僠	bort
侼	borz
䊿	bosf
紴	bosy
䞳	bot
擘	bou
䃗	boud
郣	boue
磻	bout
㪍	bouw
豰	bouy
癶	bovn
愽	boxc
懪	boxu
㞈	boyc
譒	boyt
䟛	bozl
虌	bpca
蟞	bpdi
䌘	bpdx
䋢	bpfx
䭱	bphd
蛂	bpid
徶	bpiw
柲	bpmb
䏟	bpo
㔡	bppl
襒	bppw
䇷	bpvd
㾟	bubp
荹	bucp
峬	buef
䍌	bufk
㨐	bufm
鵏	bufn
捗	bufp
钸	bujj
瓿	bul
鸔	bunu
䀯	buof
䏽	buok
䋠	busf
簿	buv
䑰	buvp
㻉	buwp
悑	buxf
誧	buyf
踄	buzp
䰽	bwal
背	bwb
㾱	bwba
㔨	bwbo
苝	bwcb
䔒	bwck
䩀	bwfb
㻗	bwfy
蛽	bwib
贝	bwk
邶	bwl
㸬	bwnl
牬	bwnp
犕	bwny
㫲	bwo
郥	bwoe
昁	bwol
褙	bwp
㸢	bwpy
㷶	bwrh
偝	bwro
俻	bwrt
㽡	bwtu
孛	bwu
勃	bwul
珼	bwwb
㤳	bwxk
䟺	bwzb
兺	bybb
䰾	baab
㶚	bado
䩗	bago
哵	bakd
䎱	balb
䇑	balu
䮂	bamd
㭭	bamd
㸭	banb
坺	batd
豝	baub
矲	baub
䶕	bavb
㿬	bavb
顮	bbbb
䚔	bbbe
汃	bbdb
濵	bbdb
椕	bbmm
豩	bbuu
璸	bbwb
髱	bcas
寳	bcbb
寚	bcbf
宲	bcbm
㲒	bcbm
駂	bcbm
䴐	bcbn
藵	bccy
蕔	bccy
㵡	bcds
骲	bcgs
忁	bciu
䥤	bcjs
䪨	bclu
靤	bcms
媬	bcnm
佨	bcrs
㙅	bctm
飹	bcue
笣	bcvs
珤	bcwf
襃	bcwy
袌	bcwy
裦	bcwy
怉	bcxs
䎂	bcxs
靌	bcyb
䨌	bcye
䤖	bcyu
㓦	bdbd
䳆	bdbn
薭	bdcu
庍	bdgj
竡	bdlb
韛	bdly
粨	bdmb
粺	bdmu
䪹	bdpb
䙓	bdps
猈	bdqu
渀	bfdc
楍	bfmk
獖	bfqb
㤓	bfxb
㔙	bgbl
鞛	bggk
㷯	bghl
䨻	bgyt
㾦	bhbk
邫	bhfb
䖫	bhig
蜯	bhil
㮄	bhmf
㭋	bhmf
鞤	bhtg
䂜	bhuf
鮅	biab
疪	bibb
疕	bibb
皀	bibb
匂	bibb
䘡	biby
㿫	biby
萞	bicb
鄨	bidb
夶	bidd
㡀	bidd
滭	bide
㓖	bide
㵥	bidm
鷩	bidn
獘	bidq
䚜	bidu
㱸	bidu
䩛	bigb
㢶	bigb
彃	bige
魓	bige
鞸	bige
弻	bigg
䯗	bigt
廦	bigu
鞞	bigu
㳼	bigu
㢸	bigw
熚	bihe
䄶	bihf
稫	biht
䖩	biib
鎞	bijb
䫾	bijb
㡙	bijb
㠲	bijb
䬛	bije
鷝	bijn
㘠	bikb
䪐	bilb
韠	bile
䉾	bilm
䵄	bima
閟	bimb
䊧	bimb
㮿	bime
毴	bimf
梐	bimt
㯇	bimt
䮠	bimt
䮡	bimw
妼	binb
贔	biob
䏶	biot
䏢	bioy
袐	bipb
䃾	bipb
禆	bipu
獙	biqw
奰	bisd
縪	bise
罼	bise
綼	bisu
䟆	bite
堛	bitt
㙄	bitt
鼊	biua
飶	biub
躄	biur
繴	biux
箆	bivb
貏	bivu
㻶	biwy
怭	bixb
愊	bixt
䣥	biyb
䫁	bizb
躃	bizu
䠋	bizu
鳻	bjbn
㪵	bjbu
岅	bjey
㚘	bjff
螁	bjig
鉡	bjjb
辬	bjlu
䉽	bjmb
姅	bjnb
䬳	bjub
䃑	bjuy
螌	bjvi
褩	bjvy
䈲	bjvy
瓪	bjwy
怑	bjxb
窉	bkbb
寎	bkbb
幷	bkbg
㓈	bkdu
鞆	bkgb
䗒	bkiy
鈵	bkjb
鉼	bkjk
梹	bkmb
䴵	bkmk
眪	bkob
仌	bkrr
氷	bkud
怲	bkxb
誁	bkyk
靐	bkyt
㣐	bmbp
藊	bmcc
䒪	bmcc
㳎	bmdc
㴜	bmdc
㳒	bmds
汳	bmdy
䛒	bmgk
稨	bmhc
甂	bmhw
徧	bmic
䡢	bmic
辧	bmlu
辡	bmlu
㵷	bmlu
㦚	bmlu
糄	bmmc
閞	bmmc
㭓	bmmc
牑	bmpc
獱	bmqb
艑	bmvc
箯	bmvg
䉸	bmvu
変	bmww
㝸	bmxe
辺	bmzd
淲	bndj
㧼	bnfy
䅺	bnhx
䮽	bnmh
䁃	bnoy
篻	bnvx
㶾	bnxh
鱍	boay
㼣	bobw
㼟	bobw
萡	bocb
㩧	bofu
㩭	bofz
䪇	bogc
瓝	bogu
煿	bohc
馛	bohd
秡	bohd
鑮	bojc
䶈	bojc
䥬	bojc
嚗	boku
䙏	bopc
仢	boru
䌟	bosu
䂍	bosu
䬪	boub
馎	bouc
礡	bouc
䭦	bouc
糪	boum
盋	boum
孹	bouz
簙	bovc
癷	bovg
艊	bovj
箥	bovy
䝛	bovy
䍸	boyc
㝿	boyy
䢪	bozk
䢌	bozl
蹳	bozy
㿜	bpbc
莂	bpcd
龞	bpda
䳤	bpdn
㢼	bpgd
䘷	bppd
䠥	bpzw
鳪	bubn
㳍	budj
廍	buge
庯	bugf
䪁	bugf
轐	buif
䬏	bujk
吥	bukb
咘	bukj
郶	bulb
䪔	bulf
勏	bull
䊇	bumf
柨	bumj
䴺	bumk
㚴	bunj
䝵	buof
㙛	butc
㘵	butj
餔	buuf
餢	buuk
䒀	buvc
篰	buve
歨	buvr
歩	buvu
藣	bwcb
㶔	bwdd
骳	bwgy
㣁	bwgy
䡶	bwiu
鉳	bwjb
䥯	bwjb
㗗	bwku
鄁	bwle
軰	bwli
梖	bwmb
桮	bwmk
㛝	bwnb
㸽	bwnb
禙	bwpo
偹	bwrt
僃	bwry
䋳	bwso
愂	bwux
誖	bwyz
𤤒	bawy
𨚔	bcbe
𠳐	bhk_
拆	caf
攃	cafx
囃	cakf
乲	cal
䌨	cas
礤	cau
礸	caub
䵽	caus
礤	caux
遪	caz
曺	ccao
蓸	ccco
嶆	cceo
撡	ccfx
鏪	ccj
鄵	ccke
䎭	cclk
㯥	ccmo
㜖	ccno
䐬	cco
襙	ccpm
褿	ccpo
傮	ccro
䒃	ccvk
屮	ccvl
懆	ccxm
愺	ccxu
䰂	cdam
揌	cdfx
啋	cdkm
棌	cdmm
婇	cdnm
䐆	cdom
䣋	cdpe
倸	cdrm
㒲	cdro
纔	cdsd
䌽	cdsm
縩	cdsx
䟀	cdtg
䠕	cdzm
跴	cdzx
敇	cea
蓛	cec
荝	cecd
萗	cecx
䔴	cecy
㨲	cefm
拺	cefn
粣	cem
䊂	cemn
硛	ceok
猠	ceon
畟	cetw
墄	cetx
硳	ceud
笧	cevc
箣	cevd
䇲	cevj
筞	cevm
簎	cevo
㥽	cexb
憡	cexn
䲋	cfa
㞥	cfe
嵾	cfep
䅾	cfh
笒	cfvv
䤁	cfy
䨙	cfyr
曽	cgbo
㣒	cgbp
竲	cglo
橧	cgmo
㬝	cgoo
䉕	cgvo
蔵	chci
凔	chdk
嵢	che
罉	chfu
䅮	chhk
螥	chi
鑶	chji
欌	chmi
賶	cho
獊	chqk
仺	chre
玱	chw
䢢	chzk
䯸	ciar
䰍	ciau
䓧	cica
茦	cicn
粢	cid
餈	cidl
垐	cidt
濨	cidx
㩞	cifm
骴	cigb
㢀	cign
螆	cii
蠀	ciib
刾	cijd
㘂	cikx
栨	cimr
嬨	cin
佌	cirb
偨	cirm
縒	cisg
絘	cisr
㞖	ciun
礠	ciux
鮆	civa
䛐	civk
飺	civl
鴜	civn
㘹	civt
㤵	cizx
朁	cja
䣟	cjae
㿊	cjby
薒	cjcm
湌	cjdl
澯	cjdm
㱚	cjdo
爘	cjhl
䳻	cjin
㨻	cjiu
囋	cjkb
噆	cjky
䝳	cjlb
㛑	cjln
㜗	cjnp
䏼	cjo
䗝	cjpi
傪	cjrp
叄	cjss
叅	cjsx
㽩	cjtp
謲	cjwp
㻮	cjwx
㥇	cjxg
䱜	coa
䰈	coag
剒	cocd
蔖	cocq
莡	cocr
蓌	cocw
嵳	coeg
㟇	coet
措	cof
髊	cogg
虘	coh
䑘	cojg
䴾	comg
㭫	comt
睉	coot
剉	cor
夎	corw
㽨	cot
瑳	cow
醝	coy
㿷	coyy
逪	cozo
䠡	cozq
遳	cozt
殩	crdm
巑	creb
穳	crhb
熶	crhy
鑹	crjv
鋑	crjw
櫕	crmb
㸑	crph
簒	crvm
簒	crvs
篹	crvv
賨	csbb
忩	csbx
茐	cscc
藂	cscn
怱	cscx
䕺	cscy
潈	csdn
漎	csdr
漗	csdx
㞱	cseo
聦	csex
爜	cshy
徖	csi
䳷	csin
従	csir
㼻	csiw
蟌	csix
鏦	csjr
鍯	csjx
㗰	cskr
楤	csmx
欉	csmy
㜡	csnr
婃	csnx
暰	cso
瞛	csor
賩	csox
悤	cspx
緫	cssx
篵	csvr
䉘	csvx
瑽	cswr
慒	csxo
誴	csyx
孮	csz
䢨	cszr
麄	cubb
瘄	cubo
麁	cudb
麤	cugb
䟟	cuir
䥄	cujo
噈	cuk
觕	cuny
䙯	cupr
縬	cusx
鼀	cuta
趗	cutr
蹙	cuw
顣	cuwb
㗤	cuwk
蹵	cuwr
憱	cuxy
䣯	cuyq
䛤	cuyr
誎	cuyu
䢐	cuzq
䠞	cuzx
踧	cuzy
皠	cvbf
疩	cvbu
㝮	cvby
㵏	cvdu
乼	cvdv
嶉	cvef
崒	cveu
䆊	cvhb
㷪	cvhn
焠	cvhu
鏙	cvjf
毳	cvm
䄟	cvmx
脃	cvob
膬	cvom
膵	cvou
䧽	cvpf
襊	cvpy
獕	cvqf
綷	cvsu
縗	cvsy
墔	cvtf
磪	cvuf
䃀	cvun
顇	cvwb
慛	cvxf
刌	cycd
拵	cyf
吋	cykc
竴	cylc
籿	cymc
膥	cymr
侟	cyrz
墫	cytc
䞭	cytw
踆	cyzw
楱	czm
楱	czmt
䃰	caux
䒑	ccba
䏆	cceo
騲	ccmu
䄚	ccpo
鼜	ccui
寀	cdbm
䴭	cdmc
䞗	cdtc
㥒	cdxm
萴	cecd
㩍	cefn
䈟	cevd
筴	cevr
驓	cgmo
䁬	cgoo
㶓	chdi
㵴	chdi
濸	chdk
朿	cian
皉	cibb
甆	cibw
薋	cicb
㓨	cidd
䳐	cidn
庛	cigb
䗹	ciix
柌	cimk
辝	cisu
趀	citp
䭣	ciua
䂣	ciub
蛓	ciui
䲿	ciun
䧳	civf
䳄	civn
䈘	civy
珁	ciww
䨏	ciyr
齹	ciyr
飡	cjdl
穇	cjhp
䱗	cjla
㣓	cjlp
嬠	cjnm
䙁	cjpg
儏	cjrm
蝅	cjti
蠺	cjti
䗞	cjti
䘉	cjti
䟃	cjtp
䉔	cjvg
憯	cjxy
㦧	cjxy
䛹	cjyu
蒫	cocg
䣜	cohe
鎈	cojg
䂳	cout
㠝	creb
䓗	cscx
潨	csdn
潀	csdn
㥖	csdx
灇	csdy
聡	csex
焧	cshx
䗓	csix
䡯	csix
棇	csmx
樬	csmx
騘	csmx
䐫	csor
䐋	csox
繱	cssx
䈡	csvx
憁	csxx
謥	csyx
瘯	cubu
䥘	cujo
媨	cuny
䃚	cuuu
竁	cvbm
凗	cvdf
濢	cvdu
㳃	cvdu
啛	cvkn
槯	cvmf
䊫	cvmf
㯔	cvmm
㯜	cvmu
粋	cvmu
㜠	cvnf
臎	cvou
䙑	cvpy
倅	cvru
伜	cvru
紣	cvsu
趡	cvtf
㱖	cvvu
翆	cvxu
忰	cvxu
澊	cydc
䍎	cyfh
𥕢	ccu_
𥮾	cjvp
嘚	dw
荅	dack
薘	dacy
溚	dadk
㟷	daek
㩉	dafx
嗒	dak
䪚	dalx
㜓	dank
䐛	dao
畣	dart
㿯	dary
䌋	dask
眔	dasu
䃮	dauy
亣	dawl
詚	dayd
迖	dazq
迏	dazt
魛	dcad
陦	dcec
屶	dced
﨩	dcee
䧂	dcek
嶌	dcen
焘	dcf
㨶	dcfn
釖	dcjd
翢	dckx
梼	dcm
䊭	dcmc
槝	dcme
檤	dcmz
㠀	dcne
祷	dcp
禂	dcpk
䌦	dcsf
軇	dcuc
噵	dczk
䒫	ddcy
䚞	dddr
軩	ddik
軚	ddit
蚮	ddiy
㶡	ddjh
䲦	ddnd
鴏	ddny
曃	ddo
黱	ddoh
袋	ddr
帒	ddrj
緿	ddsx
簤	ddvb
䈆	ddvq
瑇	ddwm
㻖	ddwn
甙	ddyg
诒	ddyk
徳	deix
棏	demc
㯖	demx
脦	deo
䙸	deoc
惪	deux
㥁	devx
恴	dewx
㩐	dffc
扥	dffv
䔲	dgca
隥	dgea
竳	dgla
䮴	dgma
櫈	dgmj
嬁	dgna
豋	dgpa
僜	dgra
凳	dgv
簦	dgva
㔁	dgvd
䳾	dgvn
憕	dgxa
䠬	dgze
蘯	dhcm
澢	dhdt
蟷	dhit
䑗	dhjw
欓	dhmh
檔	dhmt
䦒	dhmu
瞊	dho
礑	dhut
簜	dhvw
璫	dhwt
䣊	dhxe
㼕	dhxg
瓽	dhxw
鯳	diad
䯼	diah
䶍	dial
菧	dicd
藡	dick
苐	dicp
苖	dicy
阺	died
聜	dieg
埊	diet
掋	difd
梊	difm
拞	difq
䩘	digy
焍	dihp
彽	diid
蝃	diiy
鍉	dijr
嚁	dikf
䴞	dilf
䊮	dimf
梑	dimh
枤	dimq
牴	dind
㹍	dink
慸	dinx
㫝	diod
腣	dioj
䐎	dior
肑	diou
㼵	diow
眱	dioy
祶	dipp
䏑	dipr
狄	diq
仾	dirh
偙	dirj
䍕	disd
埞	ditr
豴	diuk
䂡	diuq
疐	diur
坔	diut
䑯	divp
啇	diwk
羝	diy
遆	dizj
髧	djav
殚	djd
瓭	djdw
耼	djea
聸	djek
抌	djfv
帎	djjv
匰	djka
啿	djkv
噉	djkw
駳	djmv
妉	djnv
膻	djod
腅	djoh
贉	djou
襌	djpa
褝	djpl
禫	djpu
衴	djpv
㲷	djqa
狚	djqd
僤	djra
繵	djsd
砃	djud
䭛	djuw
䉞	djvx
玬	djwd
勯	djwl
䳉	djwn
単	djxa
惔	djxh
酖	djyv
訑	djyy
㝎	dkbv
萣	dkc
薡	dkcv
㴿	dkdb
濎	dkdv
嵿	dkeb
聢	dker
㣔	dkid
帄	dkjd
鐤	dkjv
椗	dkmr
㫀	dkoj
饤	dkud
忊	dkxd
瘨	dmbb
蕇	dmca
䓦	dmcb
蒧	dmck
嵮	dmeb
攧	dmfb
蜔	dmit
奌	dmld
敟	dmlw
敁	dmly
婰	dmnb
傎	dmrb
㼭	dmtw
壂	dmut
齻	dmvb
蹎	dmzb
鮉	dnak
魡	dnau
瘹	dnbu
藋	dnc
蓧	dncm
䔙	dncu
扚	dnfu
㢯	dngm
䄪	dnhu
虭	dnid
蛁	dnik
鑃	dnjf
鼦	dnjk
鈟	dnjl
鵰	dnkn
㪕	dnly
椆	dnmk
瞗	dno
䘟	dnpl
㹦	dnqk
伄	dnrl
䂽	dnuu
䉆	dnvn
簓	dnvp
琱	dnwk
㚋	dnxk
雿	dnyd
鮵	doae
鬌	doao
痥	dobe
䒳	docm
茤	docx
沲	dody
嶞	doee
崜	doei
隋	doeo
隳	doex
挆	dofm
剫	dogd
䩔	dogy
䅜	dohi
铎	doj
䤻	dojo
刴	don
䐾	doo
仛	dorq
缍	dosi
㙐	dote
躱	doum
畓	dout
䑨	dovy
嚲	dowa
㻔	dowi
毲	doym
鵽	doyn
敪	doyw
䠤	doza
跢	dozx
镻	dpau
苵	dpcu
殜	dpdm
㲳	dpdu
嵽	dpej
峌	dpet
挕	dpfe
揲	dpfm
㩹	dpfq
㦶	dpgt
戜	dpgw
㷸	dphl
螲	dpit
幉	dpjm
啑	dpkr
咥	dpkt
耊	dplt
䳀	dpn
㬪	dpoa
㫼	dpod
眰	dpot
胅	dpou
曢	dpox
佚	dpr
㑙	dprv
絰	dpst
疉	dpta
䞇	dptb
䴑	dptn
畳	dptq
䠟	dptr
趃	dptu
臷	dput
艓	dpvm
䫕	dpwb
惵	dpxm
詄	dpyu
颩	dqjp
葮	drcy
剬	dred
鍴	drje
媏	drn
腶	dro
偳	drr
碫	druy
躖	drzv
鮗	dsad
苳	dscd
蕫	dscl
菄	dsco
涷	dsdo
湩	dsdv
峒	dse
峝	dsek
挏	dsfk
㨂	dsfo
烔	dshk
蝀	dsio
戙	dskg
㖦	dsko
㢥	dsky
駧	dsmk
㚵	dsnd
姛	dsnk
娻	dsno
嬞	dsnv
腖	dsoo
氭	dsqo
㑈	dsrd
働	dsrl
倲	dsro
墥	dstl
埬	dstn
䂢	dsud
笗	dsvd
箽	dsvv
㐑	dswv
諌	dsyo
迵	dszk
㓃	dubq
殰	dudb
靯	dugt
秺	duhq
帾	dujo
叾	dulk
螙	dumi
嬻	dunb
㸿	dune
姤	dunk
妬	dunu
䫳	dusb
剢	duud
䀾	duuo
裻	duuy
瓄	duwb
醏	duyo
䢱	duzb
䟻	duzh
兊	dvbe
薱	dvc
瀩	dvdb
㠚	dvec
㟋	dvee
陮	dvef
䯟	dvgu
䬈	dvje
㬣	dvo
鴭	dvpn
磓	dvrz
綐	dvse
㙂	dvte
塠	dvtk
磓	dvuk
憝	dvw
対	dvwc
譵	dvyc
譈	dvyw
䔻	dycw
潡	dydw
撴	dyfw
庉	dygt
䪃	dygw
橔	dymw
犜	dynw
腞	dyou
獤	dyqw
伅	dyrt
坉	dytt
壿	dyuc
碷	dyuo
墪	dywt
忳	dyxt
逇	dyzy
郖	dzae
毭	dzam
㪷	dzau
㐙	dzav
荳	dzca
阧	dzeu
㨮	dzfe
㢄	dzga
鋀	dzja
唗	dzkr
吺	dzky
梪	dzma
橷	dzme
枓	dzmu
脰	dzo
斣	dzsu
䬦	dzuy
艔	dzvy
鬪	dzwc
匒	dabk
㾑	dabk
剳	dacd
汏	dadd
羍	dady
㿴	dady
撘	dafk
䵣	dahd
燵	dahy
蟽	daiy
鎝	dajk
鎉	dajx
鐽	dajy
呾	dakd
咑	dakd
龘	dala
龖	dala
繨	dasy
㙮	datk
逹	dazg
㿒	dcbc
菿	dccd
嶹	dcec
隯	dcec
嶋	dcen
隝	dcen
稲	dcho
衟	dcii
衜	dcii
椡	dcmd
朷	dcmd
壔	dctc
翿	dcux
瓙	dcwh
辺	dczd
䆃	dczh
鮘	dday
瀻	dddb
䚟	dddc
㞭	ddde
廗	ddgj
㯂	ddmj
襶	ddpb
㐲	ddrd
柋	ddrm
侢	ddrr
帯	dduj
艜	ddvj
懛	ddxt
霴	ddyn
蹛	ddzj
淂	dedc
㝵	dedc
䙷	deoc
悳	deux
㤫	deux
䙞	dgpa
墱	dgta
艠	dgva
覴	dgve
㲪	dgvm
灙	dhdh
潒	dhdn
璗	dhdy
闣	dhmt
婸	dhnw
圵	dhtu
趤	dhtu
艡	dhvt
䣣	dhxe
㽆	dhxw
譡	dhyt
雼	dhyu
逿	dhzw
蔕	dicj
蔐	dick
蔋	dicy
奃	didd
渧	didj
㪆	didy
䧑	dier
墬	diet
嶳	diet
䏄	diet
摕	difj
弤	digd
䩚	digd
䣌	dige
靮	digu
㢩	digu
䵠	dihu
厎	diid
軧	diid
螮	diij
㣙	diiy
釱	dijd
鉪	diju
呧	dikd
唙	dikh
㭽	dimd
樀	dimk
㰅	dimk
馰	dimu
㓳	diod
䀿	dioj
旳	diou
袛	dipd
䨀	dirf
僀	dirj
趆	ditd
坘	dith
墑	ditk
磾	diua
䑭	divg
篴	divu
甋	diww
怟	dixd
鸐	dixn
頔	diyb
䨤	diyy
䢑	dizd
逓	dizj
遰	dizj
廸	dizy
窞	djbj
癚	djbk
䒟	djcd
泹	djdd
觛	djdd
刐	djdd
鴠	djdn
沊	djdu
㴷	djdv
甔	djdw
澸	djdx
㠆	djea
撢	djfu
㡺	djgd
䩥	djgv
黕	djhv
黮	djhv
㐤	djjb
嚪	djkj
㗖	djkj
嘾	djku
㕪	djkv
頕	djlb
柦	djmd
馾	djmv
媅	djnv
䐷	djoa
䄡	djpk
伔	djrj
紞	djsv
餤	djuh
䃫	djuk
躭	djuv
饏	djvl
䨵	djyu
霮	djyv
䨢	djyv
蜑	djzi
顁	dkbb
㐉	dkdv
䦺	dked
靪	dkgd
鼑	dklv
奵	dknd
甼	dktd
矴	dkud
碠	dkud
磸	dkud
顚	dmbb
㝪	dmbw
㶘	dmdu
巓	dmeb
䍄	dmfk
厧	dmib
嚸	dmkk
㓠	dmld
槙	dmmb
椣	dmmb
槇	dmmb
橂	dmmd
橝	dmmu
驔	dmmu
婝	dmnr
㞟	dmud
窵	dnbn
刟	dndd
奝	dndk
殦	dndn
鳭	dndn
䳂	dndn
弴	dngz
鋽	dnju
竨	dnlu
㒛	dnrf
䂏	dnuk
訋	dnyu
䲊	doao
敚	dobw
敓	dobw
奲	doda
凙	dodg
陏	doeo
陊	doex
夛	doex
挅	dofm
㣞	doie
鈬	doji
䤪	dojm
嚉	dokc
㖼	dokm
椯	dome
柮	domi
桗	domm
㛆	donm
㛊	donm
䙤	dopk
䙃	dopo
﨣	dotd
趓	dotm
垜	dotm
䯬	dowa
㻧	dowm
䫂	doxb
憜	doxo
㥩	doxo
墯	doxt
尮	doym
敠	doyy
跥	dozm
㩸	dpfa
蜨	dpir
㥈	dpjx
䪓	dplk
眣	dpou
褋	dppm
牃	dppm
氎	dptm
㲲	dptm
疂	dptq
褺	dpty
㦅	dpxj
恎	dpxt
㱭	drdy
㟨	dree
毈	drly
褍	drpe
㫁	drvj
䠪	drzv
鯟	dsao
㓊	dsdk
䵔	dsho
徚	dsij
鶫	dsjn
䰤	dsmg
㼯	dsmw
昸	dsod
䞒	dstk
霘	dsyk
䍶	dsyo
豄	dubb
㾄	duby
䓯	ducm
荰	duct
㱩	dudd
涜	dude
殬	dudg
韇	dugb
䪅	dugi
䩲	dugy
蝳	duim
鑟	dujb
贕	dulb
韥	dulb
覩	dule
韣	duli
䦠	dumd
䮷	dumi
騳	dumm
䙱	dupi
䲧	dutn
㞘	duud
蠧	duui
錖	duuj
皾	duuy
䈞	duvo
琽	duwo
読	duye
讟	duyk
痽	dvbf
濧	dvdc
㳔	dvdc
嵟	dvef
㨃	dvfz
䇏	dvlz
頧	dvpb
垖	dvtk
䂙	dvue
䭔	dvuk
鐜	dvwj
憞	dvxw
䨴	dvyc
䨺	dvys
䜃	dvyt
蜳	dyiz
驐	dymw
撉	dywu
䃦	dywu
憞	dyxw
踲	dyzo
遯	dyzu
䕆	dzcd
浢	dzda
乧	dzdv
㞳	dzeu
兠	dzle
闘	dzmc
閗	dzmu
㛒	dzna
䄈	dzpa
饾	dzua
䇺	dzva
鬬	dzwj
䛠	dzya
酘	dzyy
𤤸	dowm
仒	eo
魤	eeab
䱮	eead
蝁	eeai
鰪	eeam
悪	eeax
琧	eeay
頞	eebb
匎	eebd
䆓	eebe
痾	eebk
皒	eebw
蕚	eeck
涐	eed
屵	eeei
岋	eeej
娿	eeen
阨	eeev
峩	eeew
搹	eefl
搤	eefm
擜	eefq
㧖	eefv
䩹	eegl
廅	eegm
䳬	eegn
㷈	eehd
戹	eehv
頋	eeib
鈪	eejv
吪	eekb
㓵	eekd
咢	eekk
㖾	eekp
呝	eekv
妿	eeln
歺	eelx
枙	eemv
䳗	eenw
歞	eeor
睋	eeow
䄉	eep
偔	eerk
僫	eerx
䋪	ees
堨	eet
堮	eetk
堮	eetv
砐	eeuj
磀	eeup
餩	eeur
䑪	eevk
頟	eewb
䖸	eewi
珴	eeww
㦍	eexp
誐	eeyw
遌	eezk
遻	eezp
迗	eezt
齃	eezv
鞥	egg
鞥	eggc
诶	eiy
奀	enb
峎	ene
峎	eneg
煾	enh
䅰	enhx
䭓	enua
䬶	enug
䭡	enux
旕	eos
貮	erab
薾	erc
刵	ered
毦	erem
䎶	ereu
㧫	erf
轜	erie
児	erle
樲	ermb
栭	erme
㛅	erne
㚷	ernx
胹	eroe
袻	erpe
尓	erpx
㒃	errb
尒	errx
䌺	erse
衈	erxe
㔩	eebm
䕏	eecw
湂	eedk
峉	eeek
㠋	eeek
㟧	eeek
鵈	eeen
阸	eeev
㩵	eefq
蚅	eeiv
軶	eeiv
鈋	eejb
鑩	eejk
㼂	eejy
囮	eekb
卾	eeke
覨	eeke
䣞	eeke
㗁	eekk
櫮	eemk
㮙	eemk
騀	eemw
妸	eenk
䳘	eenw
䞩	eetk
礘	eeuh
硆	eeuk
砈	eeuv
豟	eeuv
砨	eeuv
䝈	eeuv
䑥	eevj
齶	eevk
䫷	eewb
讍	eeyk
詻	eeyk
䛖	eeyy
髵	erae
荋	erce
洏	erde
峏	eree
隭	eree
㢽	erge
輀	erie
唲	erke
㖇	erke
栮	erme
粫	erme
駬	erme
䮘	erme
䎟	erne
䏪	eroe
侕	erre
䋙	erse
䋩	erse
趰	ertx
䎠	erwe
弐	erya
弍	erye
誀	erye
䣵	erye
𥔲	eeuv
发	fa
凡	fj
髪	faay
疺	fabf
茷	fac
蕟	facy
法	fad
浌	fadg
㕹	fakd
橃	famy
㛲	fanb
姂	fanf
傠	farc
佱	farv
㘺	fatg
墢	faty
筏	fav
発	fava
䣹	fayg
鱝	ffab
魵	ffad
炃	ffbh
鳻	ffbn
蕡	ffcb
岎	ffe
隫	ffeb
黂	ffgb
馩	ffhb
竕	ffld
㥹	ffmx
妢	ffnd
瞓	ffo
膹	ffob
昐	ffod
偾	ffr
坆	fftw
饙	ffub
䴅	ffun
瓰	ffwa
羒	ffyd
寷	fgba
蘴	fgca
蘕	fgcf
㠦	fgea
峯	fgef
摓	fgff
䩼	fggf
煈	fghi
鎽	fgjf
凬	fgjo
凨	fgjs
麷	fgma
妦	fgnf
賵	fgo
盽	fgof
䙜	fgpf
鄷	fgqe
僼	fgra
偑	fgri
㐽	fgrx
綘	fgsf
覂	fgxf
䟪	fgzf
髣	fhaf
淓	fhdf
㯐	fhem
埅	fhet
㧍	fhff
鴋	fhfn
䄱	fhhf
㕫	fhkf
堏	fhmt
祊	fhpf
㑂	fhrb
鶭	fhsn
㤃	fhxf
趽	fhzf
鱕	fjat
㽹	fjby
薠	fjcb
蕃	fjcf
瀿	fjdx
翻	fjf
払	fjfs
旙	fjft
轓	fjit
䡊	fjiy
帆	fjj
㠶	fjjj
匥	fjkc
㕨	fjkf
梵	fjl
䪛	fjlt
䫶	fjmb
鐢	fjmj
橎	fjmt
㛯	fjnl
嬏	fjnt
嬎	fjnu
膰	fjo
䀟	fjof
䐪	fjon
反	fjp
勫	fjpl
犿	fjqb
㺕	fjqt
仮	fjry
䋦	fjsm
飰	fjub
籓	fjvt
奿	fjwn
忛	fjxf
憣	fjxt
㼝	fjxw
覅	fnx
覅	fnxw
仸	for
仏	fors
坲	fot
坲	fotf
䝾	fuab
髴	fuaf
鶝	fuah
巿	fual
鮲	fuaq
畐	fuat
鳆	fuaw
䱐	fuaz
匐	fub
荂	fuck
葍	fuct
蕧	fucw
㚕	fudf
㐢	fudv
澓	fudw
岪	fuef
陚	fuev
㠅	fuew
㟊	fuez
麸	fuf
刜	fufd
邞	fufe
盙	fufm
鴔	fufn
抚	fufv
懯	fufx
虙	fuhb
炥	fuhf
蝠	fui
蝜	fuib
蚹	fuic
鉜	fujc
帗	fujd
鍢	fujt
赙	fuk
哹	fukz
䭻	fumd
枎	fumf
栿	fumq
棴	fumy
媍	funb
婏	fund
妋	funf
娐	funz
鵩	fuon
衭	fupf
褔	fupt
䘠	fupx
袚	fupy
偩	furb
姇	furn
怤	furx
绂	fus
紨	fusc
䋨	fusk
䌿	fust
緮	fusw
罦	fusz
䞜	futb
坿	futc
畉	futf
垘	futq
㙏	futw
砩	fuu
䠵	fuuc
䑧	fuvc
箙	fuvy
玸	fuws
畗	fuwt
㤱	fuxa
䎔	fuxc
翇	fuxd
䟔	fuzb
䟮	fuzq
踾	fuzt
猤	fvqt
䰁	fwau
癈	fwby
萉	fwcb
䕁	fwcm
蕜	fwcx
䕠	fwcy
渄	fwdf
䚨	fwdy
㩌	fwfb
餥	fwfl
婓	fwfn
猆	fwfq
㐟	fwfv
廃	fwga
䨾	fwgf
䆏	fwhb
蟦	fwib
䤵	fwjf
䑔	fwjl
騑	fwmf
杮	fwml
櫠	fwmy
肺	fwo
裶	fwpf
俷	fwrb
䉬	fwvy
䠊	fwzf
炰	fzbh
鴀	fzbn
缹	fzfh
缻	fzfw
妚	fzn
妚	fznb
紑	fzs
雬	fzym
藅	facd
沷	fadd
灋	fads
鍅	fajs
䇅	falg
栰	famg
瞂	fapd
䂲	fatu
醗	faya
彂	fayu
㿎	ffbb
弅	ffbc
蚠	ffbi
朆	ffbw
蒶	ffcd
㱵	ffdb
䩿	ffgb
燌	ffhb
秎	ffhd
馚	ffhd
轒	ffib
蚡	ffid
幩	ffjb
鐼	ffjb
帉	ffjd
鈖	ffjd
橨	ffmb
枌	ffmd
梤	ffmd
燓	ffmh
㷊	ffmh
㸮	ffnd
肦	ffod
衯	ffpd
餴	ffuc
躮	ffud
鼖	ffuy
㬟	ffwo
㤋	ffxd
羵	ffyb
雰	ffyd
黺	ffyd
訜	ffyd
䒠	fgcf
飌	fgci
湗	fgdc
溄	fgdl
㵯	fgdn
捀	fgff
焨	fgho
凮	fgjb
鏠	fgjf
㡝	fgjf
鳯	fgjn
桻	fgmf
檒	fgmi
㛔	fgnf
䀱	fgof
䏎	fgof
猦	fgqi
㒥	fgra
仹	fgrf
堸	fgti
犎	fgtn
鴌	fgtn
㜂	fgtn
篈	fgvc
艂	fgvf
琒	fgwf
夆	fgwf
甮	fgwy
㦀	fgxf
霻	fgya
靊	fgya
蠭	fgzi
旊	fhfw
瓬	fhfw
錺	fhjf
䲱	fhnf
昘	fhof
眆	fhof
䢍	fhzf
䒦	fjcf
䕰	fjct
滼	fjdf
㴀	fjdf
盕	fjdm
䀀	fjdm
旛	fjft
軓	fjif
鐇	fjjt
䪤	fjjt
凣	fjlj
杋	fjmf
柉	fjmf
䭵	fjmf
颿	fjmi
蠜	fjmi
棥	fjmm
䮳	fjmt
䊩	fjmt
籵	fjmu
凢	fjpj
飜	fjpl
鷭	fjpn
襎	fjpt
㸋	fjpt
瀪	fjpu
㶗	fjpu
䌓	fjpx
䋣	fjpx
軬	fjsi
笲	fjvc
舧	fjvd
舤	fjvf
䉊	fjvi
䉒	fjvt
笵	fjvv
㤆	fjxy
䣲	fjyc
訉	fjyf
羳	fjyt
䛀	fjyy
梻	fomf
鬴	fuaf
鮄	fuaf
㽬	fuat
䭮	fuaz
㾈	fubc
釡	fubj
冨	fubt
癁	fubw
萯	fucb
荴	fucf
䓏	fuck
䓵	fuck
䕎	fuct
䔰	fuct
泭	fudc
冹	fudd
㜑	fudn
䫍	fufb
捬	fufc
尃	fufc
㓡	fufd
郙	fufe
旉	fuff
鳺	fufn
乶	fufv
㩤	fufw
㪄	fufw
弣	fugc
焤	fugh
䫝	fuhb
秿	fuhf
䄮	fuhf
㷆	fuhu
稪	fuhw
烰	fuhz
蜅	fuif
䡍	fuif
㕊	fuif
䗄	fuij
輹	fuiw
蚥	fuix
颫	fujf
鉘	fujf
鈇	fujf
鍑	fujw
咈	fukf
竎	fulc
椨	fumc
柎	fumc
糐	fumc
﨓	fumc
䮛	fumc
柫	fumf
麱	fumf
䩉	fumf
㭪	fumf
䦣	fumk
椱	fumw
麬	fumy
粰	fumz
䴸	fumz
嬔	funu
胕	fuoc
㫙	fuof
祔	fupc
禣	fupc
袝	fupc
峊	fupe
襥	fupf
䃿	fupf
蛗	fupi
䘀	fupi
鳬	fupj
㲗	fupm
䳕	fupn
甶	fupt
俌	furf
䵾	fury
䌗	fush
絥	fusq
䍖	fuss
䋹	fust
綍	fusz
綒	fusz
䞞	futf
䞸	futk
䞯	futz
䂤	fuuc
豧	fuuf
㬼	fuuw
笰	fuvf
䒇	fuvt
䒄	fuvt
艀	fuvz
筟	fuvz
㚆	fuww
㤔	fuxc
覄	fuxq
詂	fuyc
酜	fuyf
諨	fuyt
䨱	fuyw
䨗	fuyz
疿	fwbf
㵒	fwdb
奜	fwfd
䨽	fwfj
㔗	fwfl
靟	fwfm
䩁	fwfm
㹃	fwfn
馡	fwhf
厞	fwif
鼣	fwjq
騛	fwml
婔	fwnf
曊	fwob
昲	fwof
暃	fwof
㫵	fwof
蜰	fwoi
胐	fwoi
屝	fwuf
濷	fwur
䈈	fwvb
䒈	fwvb
飝	fwvl
㥱	fwxf
靅	fwyb
䛍	fwyf
𨙮	fjfe
魀	gag
旮	gaj
嘠	gakg
玍	gap
玍	gapw
櫜	gca
羙	gcbh
鷎	gcbn
藳	gcch
䓘	gcck
菒	gccm
夰	gcdl
峼	gcek
䆁	gchg
吿	gcnk
勂	gcnl
暠	gcok
鼛	gcuk
稾	gcwh
髙	gcwk
槀	gcwm
㤒	gcxu
鷱	gczn
匃	gdbr
芥	gdc
葢	gdcm
隑	gdea
峐	gder
乢	gdev
㧉	gdfq
槩	gdgm
姟	gdnr
䐩	gdoa
䏗	gdoq
䀭	gdor
祴	gdpc
侅	gdrr
絠	gdso
郂	gdwe
忋	gdxj
戈	gea
鞷	geag
臵	geak
匌	gebk
茖	geck
﨟	gecv
哥	ged
滒	gedk
䧄	geek
挌	gefk
歌	geg
戨	gegg
䪂	gegn
䗘	geim
輵	geiv
镉	gej
㠷	gejj
鎶	gejk
㖵	gekb
㗆	gekg
韚	gelg
阁	gemg
槅	geml
騔	gemv
牱	genk
䐙	geog
肐	geoq
裓	gepc
犵	geqq
獦	geqv
佮	gerk
搿	geu
䈓	gevv
愅	gexg
諽	geyg
搄	gffa
䫀	gfgb
㫔	gfo
䱍	ggaa
䱴	ggag
菮	ggcn
峺	ggeg
䎴	ggej
掶	ggfn
郠	ggge
焿	gghn
㹴	ggqg
絚	ggsa
縆	ggsg
䋁	ggsj
䌄	ggsy
堩	ggta
畊	ggtj
羮	ggyf
䢚	ggzg
䚗	ghds
㟠	ghee
㟵	ghev
掆	ghfe
	ghfx
焵	ghhe
釭	ghjg
鎠	ghjv
罓	ghkx
棡	ghme
犅	ghne
牨	ghnj
堈	ghte
㽘	ghtj
泔	gjd
漧	gjdq
㿻	gjgm
䵟	gjhg
秊	gjhq
衦	gjpg
㓧	gjrd
仠	gjrg
䊻	gjsr
䃭	gjux
笴	gjvk
迀	gjzg
㾩	gkbb
㧔	gkfw
罫	gksb
䊽	gksg
䂷	gkub
箉	gkvl
叏	gkvy
恠	gkxt
黆	glcv
茪	glcw
潢	gldb
撗	glfb
炛	glhb
臩	glil
銧	gljw
欟	glme
炗	glnh
姯	glnw
㫛	gloe
炚	gloh
僙	glrb
侊	glrw
珖	glw
㿆	goby
蔮	goca
淉	godg
㶁	godj
聝	goea
彉	gogb
褁	gogy
蝈	goi
蜾	goim
䬎	goja
鈛	gojg
嘓	goka
圀	gokf
囻	gokm
囶	gokt
㕵	gokw
啯	goky
膕	gooa
腂	goog
䙨	gopy
猓	goqg
綶	gos
墎	gote
䂸	goua
慖	goxa
惈	goxg
鱹	graf
鱞	gray
窤	grbb
悹	grbx
癏	grby
雚	grcf
潅	grdf
䚪	grdy
罆	grfb
䩪	grgk
輨	grik
鑵	grjf
䦎	grme
闗	grmh
矔	gro
䏓	groe
観	grpe
䙮	grpf
䙛	grpk
䝺	grwb
躀	grzb
髸	gsab
䰸	gsas
匑	gsbg
䲲	gsbn
䔈	gscb
㭟	gscm
䳍	gscn
觵	gsdb
䡗	gsgi
熕	gshb
輁	gsib
㔶	gskb
䐵	gsob
㫒	gsoc
糼	gssl
碽	gsub
躳	gsuk
兣	gsul
䂵	gsur
厷	gsus
篢	gsvb
羾	gsxg
鮕	guak
㾶	gubg
蓇	guco
薣	gucy
觚	gud
崓	guek
㧽	gufk
扢	gufq
故	gug
嘏	gug
稒	guhk
蛄	gui
鈲	gujg
啒	guki
唃	guky
柧	gumg
牿	gun
嫴	gunu
㚉	gunx
夃	guny
䵻	guoe
焸	guoh
脵	guot
䐻	guou
傦	gurg
䜼	gusa
縎	gusg
䍛	gusk
硲	guuk
㯏	guum
皷	guup
怘	guux
䶜	guvk
愲	guxg
逧	guzk
䲅	gvae
鱥	gvap
癐	gvbo
茥	gvct
亀	gvdd
湀	gvdt
巂	gvek
嶲	gvev
撌	gvfb
摫	gvfe
㨳	gvfk
椝	gvfm
嫢	gvfn
㧪	gvfv
鞼	gvgb
䅅	gvht
厬	gvik
蛫	gviv
䤥	gvjv
匮	gvkr
攱	gvly
槶	gvma
槻	gvme
騩	gvmg
瞶	gvob
瞡	gvoe
䁛	gvog
瞆	gvor
眭	gvot
禬	gvpo
祪	gvpv
郐	gvre
傀	gvrg
佹	gvrv
䌆	gvsg
郌	gvtb
昋	gvto
㰪	gvtr
垝	gvtv
㪈	gvty
硊	gvuv
璝	gvwb
恑	gvxv
䠩	gvzp
䯏	gxgk
㶽	gxhn
䫚	gxlb
歄	gxlr
䏦	gxok
罫	gxsb
劀	gxsd
緺	gxsk
罣	gxst
趏	gxtk
䈑	gxvk
颪	gxxi
踻	gxzk
蔉	gyck
蓘	gycy
䎾	gye
䵪	gyhb
棞	gymh
睔	gyo
睴	gyoi
裷	gypv
㙥	gytk
䃂	gyub
硍	gyug
璭	gywi
惃	gyxb
冓	gzar
㝤	gzbr
茩	gzck
拘	gzf
蚼	gzik
冓	gzjr
啂	gzkv
䝭	gzo
袧	gzpk
褠	gzpr
坸	gztk
䬲	gzuk
簼	gzvr
玽	gzwk
錷	gajv
皐	gcbd
㚖	gcbd
㾸	gcbk
㚏	gcdc
㵆	gcdk
韟	gclu
槹	gcmd
檺	gcmu
祰	gcpk
祮	gcpk
禞	gcpk
睪	gcsg
餻	gcuh
稁	gcwh
匄	gdbw
漑	gddv
摡	gdfv
㮣	gdgm
䪱	gdjb
㕢	gdly
杚	gdmq
槪	gdmv
絯	gdsr
畡	gdtr
豥	gdur
䬵	gdur
賌	gdwb
瓂	gdwm
㱾	gdwy
鮯	geak
䔅	geck
觡	gedk
㵧	gedv
彁	gegg
鞈	gegk
戓	gegk
㦴	gegk
㷴	geih
蛒	geik
轕	geiv
嗰	gekk
韐	gelk
鴐	geln
㤎	gelx
櫊	gemk
㭘	gemk
牫	geng
鴚	genk
呄	genk
䫦	getb
䪺	getb
䘁	geui
敋	geww
䨣	geyg
謌	geyk
䛿	geyl
揯	gffa
㮓	gfma
䱭	ggaa
䱎	ggag
㾘	ggbg
莄	ggcg
挭	ggfg
刯	gggd
椩	ggmn
㹹	ggqn
緪	ggsa
疘	ghbg
罁	ghfe
㧏	ghfx
䴚	ghlj
戅	ghlx
㼚	ghww
芉	gjcg
灨	gjdb
凎	gjdj
汵	gjdv
骭	gjgg
䯎	gjgg
魐	gjgn
鳱	gjgn
䲺	gjgn
㶥	gjhg
凲	gjjn
贑	gjlb
䤗	gjly
粓	gjmg
檊	gjmg
盰	gjog
亁	gjuq
倝	gjur
篢	gjvb
皯	gjvg
簳	gjvg
筸	gjvg
䇞	gjvg
尶	gjwm
忓	gjxg
㤌	gjxg
詌	gjyg
䂯	gkut
烡	glhb
灮	glhe
臦	glii
輄	gliw
㤮	glqx
俇	glrw
硄	gluw
瘑	gobk
漍	goda
㳡	godc
㳀	godg
濄	godk
䆐	gofh
彍	gogb
輠	goig
鐹	gojk
㗻	gokk
䴹	gomg
楇	gomk
䲘	grak
痯	grbk
瘝	grbu
㴦	grdk
䪀	grgx
㮡	grhm
䗰	grib
䗆	grik
鏆	grjb
錧	grjk
䤽	grju
樌	grmb
䘾	grpk
礶	gruf
泴	grum
丱	grvl
悺	grxk
䎚	grxx
覌	grye
遦	grzb
䱋	gsab
匔	gsbk
拲	gscu
㓋	gsdb
兝	gsff
㓚	gsgd
㧬	gsgu
䂬	gsgu
㼦	gsgw
慐	gsgx
幊	gsjb
㕬	gsks
龏	gslc
栱	gsmb
㯯	gsmb
杛	gsmg
䍔	gsss
塨	gstx
䇨	gsvl
㺬	gswf
愩	gsxb
㤨	gsxb
㽽	gubk
苽	gucg
䓢	guck
泒	gudg
淈	gudi
凅	gudk
濲	gudy
蛌	guig
軱	guig
盬	guim
唂	gukk
榾	gumg
䮩	gumg
棝	gumk
橭	gumu
䀦	guok
䀰	guok
祻	gupk
㒴	guri
罛	gusg
㼋	guug
䀇	guum
鼔	guuy
糓	guuy
䐨	guuy
嗀	guuy
笟	guvg
箛	guvg
䉉	guvg
篐	guvj
䀜	guwo
尳	guyg
窐	gvbt
蓕	gvct
䣀	gvde
帰	gvdj
㲹	gvdj
溎	gvdt
觤	gvdv
陒	gvev
鬹	gvfl
䐴	gvgo
庪	gvgy
螝	gvig
蟡	gvih
㔳	gvkj
櫷	gvma
椢	gvmy
㸵	gvnk
膭	gvob
䞈	gvoh
胿	gvot
襘	gvpo
袿	gvpt
䃽	gvpy
䳏	gvtn
䞨	gvtt
簂	gvva
䈐	gvvh
瓌	gvwy
䝿	gvyb
䍯	gvyv
䒷	gxck
㧓	gxfg
煱	gxhk
銽	gxjk
㒷	gxkb
叧	gxkd
冎	gxlk
騧	gxmk
䯄	gxmn
絓	gxst
㨰	gyfy
緷	gysi
謴	gyyb
䜇	gyyy
煹	gzhr
㡚	gzjr
㗕	gzkr
耈	gzlk
耉	gzlk
㺃	gzqk
㽛	gztk
䃓	gzur
撀	gzuu
㨌	gzuy
㝅	gzuy
豿	gzvk
䑦	gzvk
訽	gzyk
𤩲	gewv
𣆳	ggo_
奤	had
虾	haix
紦	havb
鰝	hcak
薧	hccb
茠	hccm
䒵	hccz
聕	hcek
㠙	hceu
㞻	hcev
秏	hchm
嚎	hck
䪽	hckb
嗥	hckg
㙱	hckt
毜	hcmx
㝀	hcmz
㚪	hcnm
暭	hcod
晧	hcok
昦	hcol
㬔	hcop
暤	hcou
獋	hcqd
傐	hcrk
䚽	hcym
䱺	hdaa
塰	hddt
㧡	hdfr
烸	hdhm
䇋	hdlx
㺔	hdqh
郂	hdwe
酼	hdyv
㜾	hdzl
鲄	heak
㿣	hebv
䒩	hech
䕣	hecv
㵑	hedb
澕	hedl
㪃	hedy
峆	hee
䳽	heen
抲	hefk
煂	hehg
蚵	heik
鉌	hejh
䶅	hejk
嗬	hekh
㕡	hely
㮝	heme
䮤	hemf
柇	hemh
籺	hemq
姀	henh
㹇	henv
䫘	heob
䏜	heoj
毼	heom
㬞	heov
袔	hepk
佫	herk
釛	herl
㪉	herw
敆	hery
䚂	hete
篕	hevm
貈	hevv
鶮	hewn
覈	hexw
訸	heyh
靏	heyn
䢔	hezk
鞎	hfgg
鞎	hfn
佷	hfr
詪	hfwg
㶇	hgdb
涥	hgdl
䯒	hggi
烆	hghi
䬝	hgjb
鑅	hgjm
䬖	hgjw
㔰	hgkb
啈	hgkg
脝	hgo
胻	hgoi
魧	hha
苀	hhcj
斻	hhfj
䣈	hhkb
貥	hhkj
桁	hhmi
妔	hhnj
䀪	hho
垳	hhti
筕	hhvi
邟	hhwe
珩	hhwi
䲳	hhwn
㰠	hhwr
㤚	hhxi
迒	hhzj
魽	hja
丆	hjap
兯	hjbe
莟	hjck
蘫	hjcm
䕿	hjcn
澏	hjde
屽	hjeg
㨔	hjfk
䧲	hjgf
攼	hjgw
甝	hjhg
蜬	hjik
哻	hjkg
唅	hjkk
㘕	hjkm
凾	hjky
䎯	hjlf
梒	hjmk
嫨	hjnf
娢	hjnk
晥	hjoe
旰	hjog
肣	hjov
㪋	hjoy
䘶	hjpk
爳	hjpl
猂	hjqg
㺖	hjqw
佄	hjrg
㒈	hjrw
䎏	hjrx
圅	hjsg
雗	hjuf
㲦	hjum
筨	hjvk
䫲	hjwb
蘹	hkcy
瀤	hkdy
㠢	hke
咶	hkkk
耲	hkly
櫰	hkmy
㜳	hkny
佪	hkrk
壊	hkty
褢	hkwy
鱑	hlab
㿠	hlbg
䳨	hlbn
鷬	hlcn
葟	hlcw
奛	hldo
䪄	hlgb
熿	hlhb
㡃	hljv
櫎	hlmb
榥	hlmg
曂	hlob
㬻	hlov
晄	hlow
䑟	hlpw
偟	hlrw
䌙	hlsb
縨	hlsw
墴	hltb
塃	hltv
堭	hltw
㠵	hlwj
衁	hlwx
兤	hlxb
怳	hlxe
恍	hlxg
㤺	hlxv
諻	hlyw
䱛	hoa
癨	hobf
萿	hock
蒦	hocy
沎	hodb
瀖	hodf
㓉	hodk
奯	hodp
捇	hofd
㨯	hofe
擭	hofy
夥	hog
㦯	hoga
䰥	hogg
惑	hoh
邩	hohe
秮	hohk
锪	hoj
䬉	hojd
㖪	hoka
咟	hokb
嚿	hokj
㘞	hokl
旤	holv
閄	hom
㯉	homh
騞	homu
檴	homy
眓	hoo
䐸	hooa
䁨	hooe
臛	hoof
矆	hooy
䄀	hopg
䄆	hopk
乥	hopv
㺢	hoqf
嗀	houy
㦎	hoxa
㦜	hoxy
靃	hoyf
謋	hoym
鵍	hrbn
酄	hrce
雈	hrcf
荁	hrcg
䒛	hrcv
浣	hrd
嵈	hrey
䴟	hrgf
㡲	hrgg
轘	hriy
䥧	hrjo
嚾	hrkf
驩	hrmf
梙	hrmi
䦡	hrmk
䭴	hrmu
槵	hrmx
阛	hrmy
㹖	hrnu
䴋	hrny
㬇	hrod
睆	hroe
欥	hror
肒	hrow
瞣	hrox
歓	hrp
狟	hrqg
垸	hrt
豲	hrux
幻	hrv
貛	hrvf
㿪	hrvw
䝠	hrvx
瑍	hrwd
懁	hrxy
讙	hryf
逭	hrz
䠉	hrzk
魟	hsa
軣	hsan
谾	hsbg
翝	hsbx
苰	hscs
澒	hsdb
浲	hsdf
澋	hsdx
䧆	hseb
巆	hsek
耾	hses
揈	hsfk
撔	hsfx
䩑	hsgg
瓨	hsgw
彋	hsgy
輷	hsik
䡏	hsis
鋐	hsjs
嚝	hskb
㖓	hskf
叿	hskg
唝	hskr
吰	hsks
䪦	hslg
粠	hsmb
闀	hsms
闂	hsmv
娂	hsn
妅	hsng
晎	hsob
仜	hsrg
纮	hss
垬	hstb
硔	hsu
硡	hsus
篊	hsvb
玒	hsw
玜	hsws
䆪	hsxg
霐	hsys
魱	huah
鯱	huaj
鰗	huao
蔰	hucb
苸	huch
芴	hucw
芐	hucx
䕶	hucy
冱	huda
隺	hudf
䚛	hudk
㨭	hufb
㧮	hufj
抇	hufo
㧾	hufx
䨼	hufy
弖	huga
䴣	hugh
䩐	hugq
韄	hugy
烀	huh
雐	huhf
鳸	huhn
虝	huhw
㕆	huik
錿	hujj
鍸	hujo
㽇	hujw
囫	huk
嘑	hukh
喖	hukk
嚛	hukm
匫	huko
嘝	huku
槴	humb
枑	humh
㦌	humx
䧼	hunf
姱	hunk
媩	huno
䊺	hush
絗	husk
壶	huu
觳	huu
䭅	huuk
瓳	huuw
簄	huvb
䇘	huvh
箶	huvo
琥	huw
㫚	huwy
㦆	huxh
䨚	huyx
䠒	huzo
鮰	hvak
瘣	hvbg
寭	hvbx
蔧	hvce
藱	hvcg
薉	hvcp
湏	hvdb
瀈	hvdi
潓	hvdx
翙	hve
隓	hveg
䜐	hvek
屷	hven
辉	hvg
廆	hvgg
㷄	hvhg
䅏	hvhm
烪	hvht
蛕	hvio
幑	hviw
圚	hvkb
槥	hvme
楎	hvmi
阓	hvmr
檓	hvmy
婎	hvn
嬒	hvno
㜇	hvnx
暳	hvoe
䏨	hvok
瞺	hvoo
睳	hvot
㬩	hvox
禈	hvpi
噕	hvpk
褘	hvpl
獩	hvqp
佪	hvrk
㑹	hvro
僡	hvrx
缋	hvs
䌇	hvsx
頮	hvub
䝅	hvut
顪	hvvb
芔	hvvl
㻅	hvws
璤	hvwx
诙	hvy
䛼	hvyg
逥	hvzk
潶	hwdh
黒	hwlh
㓰	hxad
䱻	hxag
芲	hxcb
蘤	hxch
䔢	hxck
㭉	hxcm
鷨	hxcn
蕐	hxcr
黊	hxct
澅	hxda
㟆	hxeu
搳	hxfk
鋘	hxjt
㕷	hxkb
㕲	hxkm
槬	hxmg
骅	hxmh
䴳	hxmx
婲	hxnb
姡	hxnk
嬅	hxnu
䀨	hxo
埖	hxtb
硴	hxub
畵	hxvt
璍	hxwl
㚌	hxxg
諙	hxyo
湣	hydo
䰟	hyeg
䧰	hyex
掍	hyfb
㨡	hyfu
䅱	hyha
焝	hyho
䫟	hykb
㖧	hyko
慁	hykx
䊐	hymb
䴷	hyme
昬	hymo
婫	hynb
睧	hyo
倱	hyrb
俒	hyre
㑮	hyri
繉	hysd
㥵	hyxu
鮜	hzak
鯸	hzau
䪷	hzbb
葔	hzc
洉	hzdk
帿	hzju
㸸	hznk
䳧	hznu
睺	hzou
䫛	hzrb
鄇	hzre
䂉	hzsu
豞	hzuk
皥	hcbd
皡	hcbd
皜	hcbk
薃	hcck
滈	hcdk
澔	hcdk
䧚	hcek
䧫	hceu
㩝	hcfu
嘷	hckd
噑	hckd
兞	hcke
哠	hckk
竓	hclm
椃	hcmj
曍	hcod
㬶	hcok
䯫	hcok
獔	hcqd
獆	hcqu
儫	hcru
㘪	hctm
䝥	hcvd
䝞	hcvj
籇	hcvu
悎	hcxk
諕	hcyj
譹	hcyu
㾂	hdbk
㨟	hdfa
䯐	hdgr
㰩	hdir
駴	hdmc
妎	hdnl
㰧	hdsr
㱼	hdsy
䠽	hdua
饚	hdum
餀	hdux
㤥	hdxr
寉	hebf
皬	hebf
㿥	hebf
癋	hebx
蠚	heci
萂	heck
渮	hedk
㰤	hedr
焃	hehd
爀	hehd
秴	hehk
䅂	hehk
熆	hehm
燺	hehm
㷎	hehv
惒	hehx
螛	heik
鑉	hejm
咊	hekh
哬	hekk
啝	hekk
嗃	hekk
㗿	hekk
㭱	hemj
粭	hemk
楁	hemk
㮫	hemk
麧	hemq
狢	heqk
欱	herr
䞦	hetk
盇	hetm
碋	heuk
䃒	heul
礉	heuw
㥺	hexm
詥	heyk
謞	heyk
靍	heyn
鸖	heyn
靎	heyn
䶎	hezk
䓳	hfcg
拫	hffg
噷	hfkr
㯊	hfmh
鵆	hgii
悙	hgxl
䘕	hhii
蚢	hhij
䦭	hhmo
䂫	hhul
笐	hhvj
䟘	hhzj
皔	hjbg
䗙	hjbi
谽	hjbk
豃	hjbw
䓍	hjcg
䓿	hjcg
浫	hjdg
涆	hjdg
淊	hjdj
㵄	hjdt
㟔	hjek
㟏	hjek
㢨	hjgg
䗣	hjgi
㶰	hjhg
馠	hjhk
㸁	hjhw
蜭	hjij
蛿	hjik
鋎	hjje
䥁	hjjg
鋡	hjjk
䤴	hjjk
䶃	hjjv
䍑	hjkg
㖤	hjkk
㘚	hjkw
顄	hjlb
闬	hjmg
馯	hjmg
駻	hjmg
㮀	hjmk
晘	hjog
睅	hjog
䏷	hjog
㺝	hjqm
傼	hjrf
㑵	hjru
㼨	hjrw
䍐	hjsg
螒	hjui
䮧	hjum
鶾	hjun
䈄	hjvk
鬫	hjww
㤷	hjxk
䛞	hjyg
䨡	hjyk
䣻	hjyk
譀	hjyw
蘾	hkcy
䃶	hkuy
褱	hkwy
懐	hkxy
皝	hlbg
皩	hlbg
宺	hlbv
㾮	hlbw
崲	hlew
揘	hlfw
㨪	hlfw
穔	hlhb
爌	hlhb
炾	hlhe
䅿	hlhl
熀	hlhw
䅣	hlhw
鐄	hljb
鎤	hljw
韹	hllw
䮲	hlmb
䊣	hlmb
楻	hlmw
騜	hlmw
䊗	hlmw
矌	hlob
䀮	hlov
䁜	hlow
䄓	hlpw
獚	hlqb
趪	hltb
䞹	hltw
餭	hluw
㞷	hlvw
朚	hlwo
巟	hlwv
愰	hlxw
䍿	hlxw
詤	hlyv
濊	hodp
湱	hodu
雘	hody
掝	hofa
㩇	hofa
剨	hofd
秳	hohk
㗲	hoka
吙	hokh
耯	holy
䦝	homd
曤	hoof
矐	hoof
䂄	hooy
䄑	hopo
俰	hork
艧	hovy
䉟	hovy
䣶	hoyk
䨥	hoyy
鯶	hrai
鰀	hray
寏	hrbd
䆠	hrbi
萈	hrcd
藧	hrcy
㵹	hrdd
澣	hrdg
烉	hrdh
鴅	hrdn
㶎	hrdy
㹕	hren
攌	hrfy
䯘	hrge
㼫	hrgw
㣪	hriy
喛	hrky
糫	hrmy
䀓	hrow
綄	hrse
絙	hrsg
䴉	hrsn
㕕	hrss
堚	hrti
䈠	hrvy
㪱	hrwd
瓛	hrwq
愌	hrxd
羦	hrye
䍺	hryx
宖	hsbs
谹	hsbs
䆖	hsbs
葓	hscb
渱	hsdg
渹	hsdk
浤	hsds
汯	hsds
潂	hsdy
䲨	hsgn
鞃	hsgs
㢬	hsgs
灴	hshg
焢	hshg
㶹	hshu
䎕	hshx
䡌	hsis
鉷	hsjb
䫹	hsjg
鍧	hsjk
鈜	hsjs
銾	hsju
嗊	hskb
㗢	hskl
竤	hsls
閧	hsmb
䉺	hsmg
䀧	hsob
㬴	hsob
綋	hsss
紭	hsss
䞑	hstg
䫺	hsui
䃔	hsuk
霟	hsyb
䨎	hsys
戸	huah
寣	hubk
㾰	hubo
㪶	hubu
萀	hucj
蔛	hucu
䓤	hucx
泘	hudh
鍙	hudj
㳷	hudo
汻	hudw
綔	hudx
冴	hudy
瀫	hudy
搰	hufg
摢	hufh
䰧	hugj
䩴	hugo
熩	huhb
虖	huhh
帍	huhj
焀	huhk
歑	huhr
乯	huhv
䗂	huij
幠	hujh
䬍	hujx
㗅	huko
匢	hukw
頀	huly
䪝	huly
粐	humh
䉿	humh
楛	humk
䊀	humk
楜	humo
䴯	humw
頶	hunb
婟	hunk
嫮	hunk
膴	huoh
䁫	huoh
㺀	huqx
俿	hurj
䍓	husy
垀	huth
䞱	hutk
壷	huua
螜	huui
䭌	huul
䭍	huum
鶦	huun
餬	huuo
䎁	huux
㺉	huuy
㷤	huuy
乕	huvj
䈸	huvu
曶	huwo
雽	huyh
謼	huyh
灳	hvbh
痐	hvbk
㾯	hvbn
䕇	hvcg
泋	hvdc
㱱	hvdg
洃	hvdh
濊	hvdp
㥣	hvdx
彚	hveg
㞧	hven
䧥	hvex
㨹	hvfe
㨤	hvff
拻	hvfh
撝	hvfh
㫎	hvfi
㩨	hvfx
烣	hvhh
㷐	hvht
螝	hvig
蜖	hvik
徻	hvio
䖶	hviu
鰴	hviw
蚘	hviy
䤧	hvjk
鐬	hvjp
㩓	hvju
鏸	hvjx
毇	hvjy
嘒	hvke
嚖	hvkx
靧	hvmb
䩈	hvmm
檅	hvmp
櫘	hvmx
媈	hvni
㹆	hvni
孈	hvnk
儶	hvrk
㑰	hvru
絵	hvss
䃣	hvuh
餯	hvuu
䂕	hvuu
恵	hvux
䫭	hvvb
篲	hvve
璯	hvwo
豗	hvwu
㷇	hvxh
恛	hvxk
㤬	hvxt
懳	hvxx
憓	hvxx
䜋	hvyb
㞀	hvyh
䛛	hvyk
譿	hvyx
譓	hvyx
詯	hvyz
廽	hvzk
蘳	hxct
㳸	hxdb
夻	hxdk
崋	hxel
㠏	hxel
摦	hxfg
撶	hxfl
䋀	hxhx
螖	hxig
錵	hxjb
釪	hxjy
㕦	hxkd
䇈	hxlt
椛	hxmb
糀	hxmb
杹	hxmb
舙	hxqk
繣	hxsa
磆	hxug
䶤	hxvg
㦊	hxxl
誮	hxyb
諣	hxyk
䛡	hxyk
譮	hxyo
䚠	hydb
涽	hydo
殙	hydo
觨	hydu
䅙	hyhb
轋	hyii
䡣	hyii
鼲	hyji
圂	hyku
䎜	hylb
䮝	hymi
棔	hymo
睯	hymo
㮯	hymu
忶	hyxs
䛰	hyyb
矦	hzdu
䗔	hziu
銗	hzjk
鍭	hzju
㖃	hzkk
㗋	hzku
㮢	hzmu
䞀	hzou
㬋	hzou
䙈	hzpu
犼	hzqk
㺅	hzqu
䞧	hztk
㤧	hzxk
翵	hzxn
翭	hzxu
㫗	hzyz
𨱑	hlj
䓭	iacd
芆	iaci
苴	iacq
䕓	iacx
扠	iafi
㫅	iafl
挿	iafo
靫	iagi
㢉	iagq
秅	iahq
鎈	iajg
嗏	iakm
梌	iamh
査	iamq
㛼	ianj
奼	ianq
䁟	iao
肞	iaoi
褨	iapg
偛	iarj
垞	iat
馇	iaud
㪯	iawl
剎	iaxd
㣾	iaxi
窲	icbu
㷅	ice
巐	iceu
䰫	icgw
焯	ich
煼	ichp
㶤	ichx
轈	icig
䫸	icjd
䫿	icjk
槱	icmh
眧	icok
䏚	icou
仯	icru
仦	icrx
罺	icsg
䎐	icux
巣	icxg
䜈	icyg
謿	icyo
訬	icyu
䜺	ida
㼮	idaw
㾹	idbm
䓱	idcm
㳗	iddt
拆	idf
囆	idki
喍	idkm
䐤	ido
犲	idqc
袃	idqy
㑪	idra
㾝	iebi
㔭	iebr
䚢	iedm
聅	iee
䧪	ieen
撦	iefo
烢	ieh
爡	iehi
蛼	ieii
㿭	ieiy
䰩	ielg
䁤	ieok
瞮	ieow
伡	ier
㒤	iere
俥	ieri
偖	iero
䋲	iesd
頙	ievb
屮	ievl
䒆	ievw
㤴	iexv
䜠	iey
迠	iezk
䆣	ifbn
瘎	ifbv
茞	ifcl
莀	ifcn
蔯	ifco
薼	ifct
莐	ifcv
㴴	ifdh
䫈	ifeb
螴	ifei
敶	ifew
捵	iffb
揨	iffd
麎	ifgn
烥	ifhi
䣅	ifie
㫳	ifio
敐	ifiw
䢅	ifjn
鈂	ifjv
棽	ifl
榇	ifm
䞋	ifoe
賝	ifom
曟	ifon
贂	ifop
䫖	ifqb
夦	ifqx
偁	ifrr
綝	ifsm
墋	iftp
㥲	ifux
忱	ifx
諃	ifym
迧	ifzu
䟢	ifzx
鯎	iga
竀	igbe
䆵	igbo
荿	igci
䕝	igcr
峸	ige
䧕	igea
阷	igev
摚	igft
程	igh
䫆	igib
徎	igiw
鏳	igjo
脀	iglo
枨	igm
朾	igmd
棦	igml
騬	igmn
橕	igmy
㛵	ign
䁎	igod
脭	igow
爯	igpr
侱	igrw
頳	igtb
塖	igtn
畻	igtt
䇸	igvw
椉	igwm
䟫	igxr
憆	igxt
悜	igxw
瓺	ihaw
䯴	ihay
淌	ihdk
淐	ihdo
䩨	ihgd
䗅	ihid
蟐	ihij
䗉	ihio
鏛	ihjj
锠	ihjo
膓	ihow
㫤	ihoy
裮	ihpo
倘	ihrk
畼	ihtw
鼚	ihun
仧	ihur
琩	ihwo
玚	ihwp
氅	ihx
甞	ihxg
鵄	iian
䜻	iiar
䜵	iiay
痸	iibd
㱀	iibr
荎	iict
鸱	iid
淔	iidq
奓	iidx
岻	iied
蚩	iiei
㞴	iieu
㞿	iiex
䀸	iifo
抶	iifu
拸	iifx
㡿	iigp
黐	iihd
烾	iiht
䤲	iijd
呎	iiki
噄	iikx
䮻	iimc
䳵	iimn
㮛	iimr
䮈	iimx
䠠	iinr
瞝	iiod
眙	iiok
腟	iiot
䙙	iipn
袳	iipx
䑛	iiqd
㺈	iiqi
侙	iirg
絺	iisj
趩	iitb
趍	iitx
饎	iiuk
杘	iium
鷘	iiun
歯	iivm
妛	iivn
䇪	iivt
㙜	iiwt
袲	iiwy
卶	iixe
恜	iixg
翨	iixr
訵	iiye
雴	iiyl
䜄	iiyn
䟷	iizj
遫	iizw
遅	iizy
䱿	ija
䵐	ijca
劖	ijdd
酁	ijde
滻	ijdu
䫮	ijeb
嵼	ijeu
摲	ijfj
鄽	ijge
㶣	ijgh
燀	ijha
䡲	ijia
蝊	ijir
幝	ijja
鋋	ijjv
嚵	ijkd
䪜	ijlk
欃	ijmd
䴼	ijmg
㯆	ijmu
㰫	ijnr
䂁	ijod
䑎	ijoj
䀡	ijok
䐮	ijou
㸥	ijpd
㺗	ijqa
㺥	ijqd
㹽	ijqg
僝	ijrz
繟	ijsa
繵	ijsd
緾	ijsl
纒	ijst
㙴	ijtk
壥	ijtt
懴	ijxj
譂	ijya
醦	ijyp
䜛	ijyv
䠨	ijzk
㪜	ikey
䴝	ikly
䦷	ikm
䦟	ikmt
膪	iko
膗	ikof
膪	ikok
欼	ikyr
剏	ilbr
㼽	ildw
漺	ildx
摐	ilfr
刱	iljd
㡖	iljv
䎫	illw
橦	ilml
䄝	ilpj
牎	ilpx
刅	ilrd
傸	ilrx
䃥	ilul
磢	ilux
䓎	ioc
涰	iod
㲋	iodb
㚟	iodd
擉	iof
繛	iofu
鑡	ioj
嚽	iokb
婥	ion
娖	ionr
娕	ionu
腏	ioo
辵	iop
䋘	iosl
趠	iot
磭	iou
㪬	ioxy
酫	ioy
歠	ioyr
荈	ircl
㼷	ire
輲	irie
㯌	irmu
賗	iro
暷	iroc
僢	irrl
剶	irvd
舡	irvg
鶨	irvn
巛	irvv
瑏	irwy
崈	isbe
䆹	isbl
䆔	isbv
漴	isd
浺	isdv
㓽	ised
隀	isev
㧤	isfe
揰	isfv
憃	isfx
爞	ishi
㹐	isin
蝩	isiv
虫	isk
嘃	iskl
㮔	ismv
䘪	ispe
䖝	ispi
褈	ispv
䌬	issa
罿	issl
緟	issv
埫	istk
䝑	isul
艟	isv
䳯	isvn
㤝	isxe
蹖	iszj
豖	iuan
䜴	iuay
鶵	iubn
蒭	iucp
刍	iud
銐	iudj
拀	iufe
䅳	iuhp
欪	iuir
幮	iujc
㐥	iujv
㗙	iukp
楚	iul
䇍	iulr
竐	iuly
杵	ium
楮	ium
橻	iumi
檚	iumr
樗	iumv
㛀	iun
犓	iunp
臅	iuo
䐍	iuoa
䙘	iupx
儊	iurr
傗	iurt
歜	iusr
趎	iutv
埱	iuty
豖	iuud
敊	iuuy
貙	iuvk
齼	iuvr
鄐	iuwe
憷	iux
踀	iuzr
菙	ivci
䍋	ivfi
搥	ivfk
搥	ivfz
㷃	ivhd
桘	ivmk
腄	ivo
腄	ivoi
埀	ivqt
顀	ivrb
龡	ivrr
䞼	ivtu
䫄	ixbb
䊬	ixhm
㔍	ixvd
䵵	ixvh
鰆	iyao
鯙	iyaz
萶	iyco
滣	iydk
浱	iydn
湻	iydo
陙	iye
惷	iyfx
䫃	iyib
䥎	iyjo
錞	iyjz
㖺	iyko
杶	iymt
媋	iyno
犉	iynz
朐	iyo
䏛	iyod
睶	iyoo
肫	iyot
鶞	iypn
偆	iyro
旾	iyto
箺	iyvo
㝄	iywt
㝇	iywz
醕	iyyo
䣩	iyyt
踳	iyzo
䲖	izac
皗	izbk
薵	izcc
䔏	izck
菗	izcy
殠	izdq
搊	izfp
㨨	izft
燽	izhc
吜	izk
䪮	izlp
梼	izmc
㮲	izmp
栦	izmv
婤	izn
嬦	iznc
矁	izox
裯	izpk
㐜	izqj
雠	izr
丒	izra
偢	izrh
讐	izrk
䀺	izro
䌧	izsc
畤	iztc
魗	izug
㦞	izux
篘	izvp
懤	izxc
詶	izyv
臰	izzb
䒲	iacq
扱	iafj
揷	iafj
㢒	iagq
䅊	iahq
銟	iajj
䤩	iajq
㮑	iamj
詧	iapk
臿	iaqj
紁	iasi
䶪	iavf
艖	iavg
疀	iavr
㤞	iaxq
䡨	iayi
䟕	iazi
鼌	icdd
漅	icdg
欩	icdr
觘	icdu
樔	icmg
麨	icmu
牊	icpk
鄛	icve
䘍	idci
祡	idvx
訍	idyi
莗	ieci
㵔	iedo
㳧	iedv
烲	iefh
㨋	iefo
硩	iefu
勶	ieil
䞣	ieti
㥉	iexk
䛸	ieyk
㽸	ifbv
䒞	ifcv
䢻	ifie
䢈	ifio
軙	ifiy
䤟	ifjj
鍖	ifjv
嚫	ifke
㕴	ifkj
樄	ifmo
䐜	ifob
鷐	ifon
䀼	ifon
儭	ifre
㧱	ifru
趂	iftx
䠳	ifui
䑣	ifvp
齓	ifvv
愖	ifxv
謓	ifyb
䜟	ifyj
霃	ifyv
趻	ifzv
踸	ifzv
䆑	igbd
窚	igbi
洆	igda
浾	igdd
溗	igdn
泟	igdv
瀓	igdw
㓌	igdw
掁	igfd
挰	igfw
靗	igfw
穪	ighx
虰	igid
郕	igie
䚘	igii
䗀	igiw
㼩	igiw
鏿	igjm
㞼	igle
䮪	igmm
檙	igmv
娍	igni
睈	igow
䄇	igpw
乗	igqm
㐼	igru
緽	igsb
絾	igsi
䞓	igtg
堘	igtt
碀	igul
饓	igum
筬	igvi
㲂	igxy
䟓	igzd
镸	ihas
凔	ihdk
焻	ihho
䅛	ihho
鋹	ihjd
鋿	ihjk
韔	ihld
椙	ihmo
䮖	ihmo
晿	ihoo
僘	ihrw
㙊	ihtd
兏	ihve
瑺	ihwj
㦂	ihxx
誯	ihyo
䠆	ihzd
瘈	iibd
㔑	iicd
湁	iidk
懘	iidx
䧝	iiei
㰞	iier
攡	iiff
䰡	iigu
㢁	iigx
㢋	iigx
㢮	iigy
㷰	iihd
㶴	iihx
蚳	iiid
蚇	iiii
鉓	iijj
鉹	iijx
叺	iikr
翤	iikx
耛	iilk
彨	iilp
彲	iilp
䪧	iily
麶	iimd
㓼	iimd
勑	iiml
粚	iimy
貾	iiod
胵	iiot
肔	iioy
裭	iipj
俿	iirj
䶵	iirj
㘜	iirk
㒆	iirx
䊼	iisv
灻	iith
䞾	iitj
㽚	iitn
赿	iitu
垑	iitx
勅	iiul
鶒	iiun
慗	iiux
歭	iivc
箎	iivj
齝	iivk
竾	iivy
筂	iivy
䶔	iivy
㥡	iixm
憏	iixx
翄	iixy
誺	iiyr
謘	iiyu
䜉	iiyu
跮	iizt
遟	iizu
灛	ijda
瀺	ijdd
毚	ijdd
湹	ijdl
潹	ijdm
䧯	ijed
摌	ijfu
䩶	ijgi
㢆	ijgl
煘	ijhk
䣑	ijie
磛	ijiu
鋓	ijjd
䥀	ijji
幨	ijjk
䤫	ijjv
㤐	ijlx
閳	ijmi
棎	ijmm
㚲	ijnk
㹌	ijnu
㬄	ijod
裧	ijph
丳	ijpl
獑	ijqj
儃	ijrd
㙻	ijtt
硟	ijuv
艬	ijvd
簅	ijvu
㦃	ijxu
䊲	ijxu
誗	ijyd
讇	ijyj
䤘	ijyj
㢟	ijzv
䦤	ikmy
㪓	ikqy
剙	ilbd
窻	ilbx
䆫	ilbx
䚒	ille
牕	ilpx
䭚	ilul
㱛	irdd
汌	irdi
歂	irer
䁣	iroc
猭	irqu
篅	irve
舩	irvs
玔	irwi
徸	isil
䡴	isil
䂌	issl
㾥	iuby
蒢	iuch
蕏	iuco
岀	iuee
䖏	iuhc
蟵	iuic
㕑	iuic
㔘	iuil
㕏	iuiu
㡡	iujc
鉏	iujq
嘼	iukk
竌	iulj
䎝	iulx
櫉	iumc
榋	iume
䊰	iumo
閦	iumr
䠂	iumr
䦌	iumt
椘	iumv
禇	iupo
㙇	iutd
豠	iuuq
篨	iuvh
齭	iuvj
珿	iuwr
璴	iuwr
㤕	iuxi
䎌	iuxr
諔	iuyy
䠧	iuzo
䟣	iuzu
䟞	iuzu
㝽	ivyu
㿤	iybo
萅	iyco
䔚	iyco
䓐	iyct
漘	iydo
䡅	iyii
輴	iyio
䞐	iyko
櫄	iymh
槆	iymo
橁	iymo
䮞	iymo
䦮	iymo
㸪	iyni
暙	iyoo
賰	iyoo
䐏	iyoo
䞺	iyto
㿧	izbc
䓓	izcc
㵞	izdx
嚋	izkc
杽	izmu
雔	izrf
犫	izrn
絒	izsv
紬	izsy
㤽	izxc
怞	izxy
遚	izzy
𥻗	iamd
𡝐	ianh
𠧚	iilr
兓	jba
㬜	jbao
寖	jbby
蓳	jbca
荕	jbcl
黅	jbcv
䒺	jbcx
堻	jbdt
凚	jbdx
嶜	jbey
搢	jbfo
厪	jbia
赆	jbk
嚍	jbkm
䫴	jbmb
㯸	jbmm
㱈	jbmr
㯲	jbmx
㝻	jbnu
㬐	jbo
䝲	jbod
䘳	jbpj
侭	jbrd
䌍	jbsa
䋮	jbsj
埐	jbty
䈽	jbva
䀆	jbvm
慬	jbx
惍	jbxj
鰿	jiab
䰏	jiaf
旡	jiav
鰶	jiax
鯚	jiaz
兾	jibb
皍	jibe
鸄	jibn
痵	jibz
蘎	jicb
䓫	jick
蕀	jicn
蘻	jicx
汲	jid
泲	jidp
嶯	jiea
隮	jiel
㠍	jiem
坖	jiet
峜	jiev
揤	jife
廭	jigb
鞊	jigk
䀈	jigm
䳭	jign
鞿	jigp
季	jih
穧	jiha
㛷	jihn
檕	jiim
毄	jiiy
鑇	jija
鍓	jije
鑙	jijo
鐖	jijr
銈	jijt
咭	jik
哜	jikl
㗱	jikm
乩	jil
耭	jilr
橶	jimg
樭	jimt
檵	jimv
梞	jimx
䐚	jioe
䐀	jiok
膌	jioo
脨	jiou
䁶	jiow
暩	jiox
䝸	jioy
禨	jipr
刉	jiqd
犱	jiqw
亼	jira
亽	jird
偮	jire
雧	jirm
䍤	jisa
㠱	jisb
羇	jisk
紒	jisl
䋟	jisx
䟌	jitf
饥	jiu
賷	jiub
㞛	jiuo
艥	jiva
鷑	jivn
璾	jiwa
㻷	jiwn
㻑	jiwz
㥛	jixa
忣	jixj
憿	jixw
䨖	jiyo
㡮	jiyq
㡭	jiyv
譤	jiyw
臮	jizn
䠏	jizt
巠	jkag
坙	jkat
荆	jkc
㢣	jkcc
憼	jkcx
泾	jkd
浄	jkdl
㣏	jkdp
聙	jkeo
旌	jkf
旍	jkfs
麠	jkga
弪	jkgg
稉	jkhg
丼	jkjd
妌	jknj
婛	jknx
睛	jko
腈	jkoq
曔	jkow
傹	jkre
俓	jkrg
経	jkst
颈	jkv
箐	jkvo
坕	jkvt
璥	jkw
璄	jkwe
誩	jkwk
鶁	jkwn
䜘	jkyw
畺	jlaa
䜫	jlbg
葁	jlcn
殭	jlda
嵹	jlei
摪	jlfc
䥒	jlgj
謽	jlgk
匞	jlkg
橿	jlma
㯍	jlmc
糡	jlme
㹔	jlna
䁰	jlob
㢡	jlpc
螿	jlpi
袶	jlpl
傋	jlrr
畕	jltt
䉃	jlvc
夅	jlwl
鰔	jmak
鰎	jmay
臶	jmaz
䚊	jmbe
弿	jmbg
寋	jmbv
䔐	jmcg
蔪	jmcj
菺	jmco
藆	jmcu
葏	jmcy
渐	jmd
冿	jmdy
䧖	jmeg
挸	jmfe
㨴	jmfq
旔	jmfy
䶬	jmga
麉	jmgb
韀	jmgh
䯡	jmgn
㓺	jmhd
䅐	jmhe
馢	jmhg
䄯	jmhk
鵳	jmhn
熞	jmht
譼	jmik
轞	jmim
徤	jmiy
鑬	jmje
帴	jmjg
鑯	jmjj
鑳	jmjr
鋑	jmjw
鳽	jmkn
鹸	jmlr
楗	jmm
㰄	jmmg
検	jmmr
樫	jmmt
賎	jmog
瞯	jmoo
睷	jmoy
袸	jmpz
猏	jmqo
俴	jmrg
倹	jmrr
䌑	jmst
䵡	jmth
硷	jmua
䭠	jmun
礆	jmur
䭈	jmuy
笕	jmv
䶢	jmvk
䉍	jmvx
瑊	jmwk
䶠	jmwr
玪	jmwv
䌠	jmwx
珔	jmwz
艰	jmy
譾	jmyx
詃	jmyy
跈	jmzp
䟢	jmzx
鱎	jnak
窌	jnbe
㽱	jnbl
㰾	jnbr
㽲	jnbv
㳅	jndb
㠐	jnek
撹	jnfe
捁	jnfk
挢	jnfl
㩰	jnfm
挍	jnfx
焳	jnhf
轇	jnip
䥞	jnjw
嘄	jnkm
嘦	jnkn
噭	jnkw
骄	jnm
孂	jnnm
嬓	jnnw
㬭	jnoc
膲	jnoh
暞	jnom
曒	jnow
䘨	jnpx
獥	jnqw
僬	jnr
㲬	jnrm
纐	jnsb
䌭	jnsh
簥	jnvk
珓	jnwx
敎	jnxw
釂	jnyc
鷮	jnyn
踋	jnze
蹻	jnzk
臫	jnzv
魝	jpad
䲙	jpae
䦈	jpag
䰺	jpaj
魪	jpal
疌	jpar
痎	jpbr
㾏	jpbt
莭	jpce
䕙	jpcf
䕸	jpck
菨	jpcn
蓵	jpcr
㓗	jpdx
觧	jpdy
卪	jped
嶻	jpef
巀	jpeg
岕	jpel
嵥	jpem
掲	jpfb
擳	jpfe
擮	jpff
斺	jpfl
㨩	jpfz
骱	jpg
鞂	jpgh
煯	jphb
蝔	jpib
蠘	jpif
徣	jpio
解	jpj
幯	jpje
㠹	jpjl
鉣	jpjs
吤	jpkl
喼	jpkx
耤	jplo
楐	jpml
楬	jpmv
毑	jpmy
媘	jpnb
犗	jpnk
妎	jpnl
媎	jpno
昅	jpoj
䀷	jpol
脻	jpor
衸	jppl
劫	jpq
䲸	jprn
倢	jprr
䌖	jpsm
繲	jpsn
刦	jptd
畍	jptl
刼	jptr
䃈	jpub
飷	jpuq
㦢	jpxe
尐	jpxp
㘶	jpxt
尐	jpxv
䛺	jpyl
謯	jpyq
迼	jpzk
踕	jpzr
镹	jqaj
鯦	jqak
萛	jqcc
殧	jqdy
摎	jqfp
㡱	jqgj
麔	jqgk
䡂	jqil
鸠	jqj
㲃	jqly
䊘	jqmo
樛	jqmp
臼	jqp
舏	jqql
倃	jqrk
紤	jqsj
㺩	jqwl
㺵	jqwr
弮	jrbg
䖭	jrbi
劵	jrbl
菤	jrcv
奆	jrdj
淃	jrdv
嶲	jre
䳪	jren
㢧	jrg
㷷	jrhb
锩	jrj
鋗	jrjo
鋑	jrjw
瓹	jrkw
棬	jrm
㯞	jrmo
姢	jrno
婘	jrnv
睊	jro
睠	jrov
朘	jrow
裐	jrp
獧	jrqy
縳	jrsc
埍	jrto
慻	jrxo
䣺	jryo
顈	jsbb
蘏	jscb
褧	jsey
燑	jshl
燛	jsih
駉	jsmk
駫	jsmw
㷗	jsph
澃	jspu
侰	jsrk
絅	jssk
埛	jstk
㤯	jsxk
逈	jszk
鳜	jta
欮	jtbr
蕝	jtcb
芵	jtcg
泬	jtdb
觼	jtdw
嶡	jter
㟲	jtex
㩱	jtfc
鴂	jtgn
熦	jthf
燋	jthh
䖼	jtie
蚗	jtig
蟨	jtii
橜	jtim
鷢	jtin
蟩	jtir
憠	jtix
䁷	jtjo
爴	jtkv
橛	jtm
㰐	jtmo
妜	jtng
䏐	jtog
䏣	jtoq
臄	jtou
覐	jtox
䐘	jtoy
䘿	jtpi
䙠	jtpr
㹟	jtqg
龣	jtru
㔢	jtsl
赽	jttg
趉	jtti
屩	jtuk
瑴	jtuy
斍	jtwe
㻕	jtwi
覚	jtxe
叕	jtyy
趹	jtzg
蹻	jtzk
鮔	juaj
鮈	juak
邭	jube
蓻	jucw
崌	jueg
焣	jueh
陱	juem
埾	juet
聥	juey
㩀	jufc
捄	jufq
抅	jufs
虡	juhb
豦	juhu
蚷	juij
蜛	juik
䗇	juim
啹	jukk
椐	jumg
檋	jumi
驹	jumj
姖	junj
婮	junk
腒	juo
郹	juoe
㬬	juof
䡞	juoi
昛	juoj
眗	juok
㮂	juom
䀠	juoo
狊	juoq
愳	juox
袓	jupq
襷	jupu
䄔	jupy
䢸	juqe
鴡	juqn
倶	jurb
倨	jurg
僪	jurk
罝	jusq
壉	jutu
榘	juum
貗	juvn
珇	juwq
怚	juxq
挙	juxu
諊	juym
踘	juzm
跙	juzq
瘕	jxb
宊	jxbq
㿓	jxbr
䕛	jxcr
㪴	jxeu
挟	jxf
拮	jxfk
扴	jxfl
䴥	jxgk
㗎	jxk
䑝	jxkl
甲	jxl
椵	jxmy
䀫	jxok
脥	jxor
腵	jxoy
猰	jxqd
圿	jxtl
埉	jxtr
鴶	jxun
豭	jxuy
叚	jxvy
㝦	jybn
寯	jybv
䕑	jycn
陖	jyew
麏	jygk
蜠	jyih
銁	jyjo
呁	jykd
㖥	jykh
㚬	jynd
姰	jyno
䐃	jyoh
儁	jyrv
㕙	jysd
鵕	jysn
㽙	jyte
馂	jyuw
鵘	jyyn
䆮	jbby
菫	jbca
漌	jbda
㴆	jbdj
觔	jbdl
濅	jbdy
㨷	jbfa
㧆	jbfj
㶦	jbhl
煡	jbhy
䗯	jbif
釿	jbjj
䤺	jbjj
劤	jbjl
鹶	jblv
枃	jbmd
嫤	jbna
㹏	jbna
嬧	jbnm
伒	jbrj
仐	jbru
僸	jbrx
紟	jbsv
䌝	jbsx
壗	jbtm
砛	jbuv
䭙	jbuy
䃡	jbuy
䈥	jbvl
䶖	jbvv
䑤	jbvv
齽	jbvx
㻱	jbwf
琻	jbwj
䥆	jbwj
璶	jbwm
㦗	jbxx
㶳	jbyh
䤐	jbyy
魥	jiaj
䦇	jiav
癠	jiba
癪	jibb
卽	jibe
㽺	jibj
谻	jibl
㾊	jibn
㾵	jibu
旣	jibv
㦘	jibx
㲅	jiby
㞃	jiby
葪	jicd
蘮	jicd
鄿	jice
䕤	jice
虀	jicj
䓽	jicj
茍	jick
蔇	jicv
済	jida
濈	jida
湒	jide
㴉	jide
㴕	jidh
觙	jidj
㚡	jidk
潗	jidm
㲺	jidq
敧	jidy
漃	jidy
㳵	jidz
㞦	jiej
㠎	jiem
㨈	jifa
撠	jifg
裚	jify
鱀	jiga
䩯	jiga
曁	jigd
庴	jigo
魕	jigr
鬾	jigy
㸄	jiha
稘	jihb
嵆	jihe
㧀	jihj
稩	jiho
穖	jihr
穊	jihv
蝍	jiie
轚	jiii
彶	jiij
䗗	jiik
䗁	jiik
螏	jiiu
撃	jiiu
繋	jiix
䶓	jija
錤	jijb
䢳	jije
銡	jijk
鏶	jijm
妀	jijn
鵋	jijn
䲯	jijn
㤂	jijx
嗘	jikd
喞	jike
㘍	jikg
㗊	jikk
䣢	jile
㦸	jilg
焏	jilh
櫅	jima
檝	jima
䮺	jima
楖	jime
槣	jimk
㭲	jimk
㮷	jimo
槉	jimu
㮨	jimw
㹄	jinw
䁒	jioe
䐕	jioe
襀	jipb
襋	jipn
鶏	jipn
禝	jipw
刏	jiqd
狤	jiqk
諅	jiqk
㔕	jiql
㫷	jiqo
朞	jiqo
㰟	jiqr
卙	jiqu
雦	jirf
僟	jirr
㑧	jirz
継	jism
趌	jitk
㙫	jitm
㚻	jitn
塉	jito
䞘	jitq
䟇	jitr
㙨	jitr
叝	jity
䂑	jiub
郆	jiue
䚐	jiue
躸	jiuk
鮆	jiva
彑	jiva
䶩	jiva
箿	jive
筓	jivg
丮	jivl
䇫	jivl
簊	jivt
剤	jiwd
齌	jiwh
韲	jiwj
懻	jixb
㥍	jixb
覉	jixk
覊	jixm
愱	jixu
霵	jiya
䜞	jiya
䛴	jiyk
㞆	jiyk
鳮	jiyn
䤒	jiyr
䛋	jiyw
誋	jiyx
﨤	jizj
䢋	jizl
踖	jizo
躤	jizo
鵛	jkan
穽	jkbj
宑	jkbj
䔔	jkce
蟼	jkci
瀞	jkdl
鶄	jkfn
䵞	jkhd
秔	jkhj
燝	jkhx
坓	jkjt
汬	jkju
幜	jkjx
竸	jkle
䪫	jklg
梷	jklm
竧	jklu
桱	jkmg
橸	jkmo
婙	jknl
暻	jkox
㬌	jkox
㘫	jktj
亰	jkwx
頚	jkyb
踁	jkzg
奨	jldd
滰	jlde
螀	jldi
醤	jldy
摾	jlfi
弜	jlgg
勥	jlgl
䗵	jlia
顜	jljb
櫤	jlmd
杢	jlmg
奬	jlpd
䋌	jlsj
壃	jlta
疅	jlta
䞪	jltj
塂	jlts
䒂	jlvc
翞	jlxx
鬋	jmad
蠒	jmai
葥	jmcd
䓸	jmcg
虃	jmcj
葌	jmcn
蕑	jmco
蕳	jmco
㳨	jmdd
聻	jmde
瀳	jmdh
瀸	jmdj
瀐	jmdj
殱	jmdj
㵎	jmdo
㶕	jmdo
瀽	jmdr
湕	jmdy
䤔	jmdy
洊	jmdz
擶	jmfd
揃	jmfd
㨵	jmfd
幵	jmgg
彅	jmgl
㦰	jmgr
熸	jmhy
㔋	jmid
㣤	jmig
鍳	jmij
螹	jmij
㯺	jmim
䟅	jmir
鏩	jmjj
㡨	jmjj
䥜	jmjm
釼	jmjn
鐗	jmjo
鐱	jmjr
䵤	jmkh
鹻	jmln
椾	jmmd
糋	jmmd
覸	jmme
覵	jmme
櫼	jmmj
椷	jmmk
榗	jmmo
橺	jmmo
䮿	jmmr
㭴	jmmt
栫	jmmz
姧	jmng
囏	jmnk
瞷	jmoo
襺	jmpi
襉	jmpo
㔓	jmql
劎	jmrd
剣	jmrd
劔	jmrn
剱	jmrr
絸	jmse
繝	jmso
墹	jmto
趝	jmtx
豣	jmug
碊	jmug
䬻	jmug
餰	jmui
豜	jmuk
礛	jmum
磵	jmuo
礀	jmuo
籛	jmvg
䇟	jmvl
瑐	jmwd
惤	jmxy
謭	jmyd
諓	jmyg
䟰	jmzi
譥	jnbk
芁	jncj
茮	jncx
灚	jnde
潐	jndh
䚩	jndk
䀊	jndm
鵤	jndn
㶀	jndp
嶕	jneh
嶣	jneh
摷	jnfg
䍊	jnfx
煍	jnhh
穚	jnhk
湬	jnhu
烄	jnhx
蟭	jnih
蟜	jnik
鐎	jnjh
劋	jnkd
嘂	jnkk
呌	jnku
櫵	jnmh
㭂	jnmx
䂃	jnoc
晈	jnox
賋	jnox
䶰	jnpm
燞	jnrh
儌	jnrw
趭	jnth
笅	jnvx
虠	jnwj
鵁	jnwn
憍	jnxk
譑	jnyk
訆	jnyl
敿	jnyw
敽	jnyy
䢒	jnzx
䱄	jpag
镼	jpai
䯰	jpal
㝏	jpbl
鶛	jpbn
㿍	jpbn
滐	jpdm
楶	jpdm
㼪	jpdw
崨	jper
擑	jpfa
䣠	jpfe
㨗	jpfr
庎	jpgl
䇒	jpgl
㸅	jphe
䅥	jphv
蛶	jpic
䗻	jpie
㞯	jpje
鎅	jpjl
鍻	jpjv
䥛	jpjx
丯	jplp
櫭	jpmd
㮞	jpmk
桝	jpml
榤	jpmm
椄	jpmn
㮮	jpmu
嫅	jpng
媫	jpnr
䀹	jpor
㫸	jpor
衱	jppj
袺	jppk
㔚	jpql
㑘	jprc
偼	jprr
刧	jptd
堺	jptl
䂝	jpug
蠽	jpui
砎	jpul
䂶	jpul
礍	jpuv
蠞	jpvi
琾	jpwl
忦	jpxl
誱	jpyr
䆶	jqbh
勼	jqbj
㝌	jqbj
䆒	jqbw
匓	jqby
韮	jqcj
汣	jqdj
揂	jqfy
㩆	jqfy
廐	jqgv
廏	jqgy
䅢	jqho
揫	jqhu
䊆	jqjm
䳎	jqjn
㐇	jqjv
匛	jqkj
匶	jqkj
杦	jqmj
欍	jqmj
朻	jqml
柾	jqmv
奺	jqnj
牞	jqnl
㸨	jqnl
慦	jqqx
糺	jqsv
畂	jqtj
䬨	jquj
齨	jqvj
丩	jqvl
䛮	jqyk
乣	jqyv
帣	jrbj
巻	jrbj
勬	jrbl
餋	jrbl
飬	jrbl
絭	jrbx
䄅	jrbx
蔨	jrcv
㢾	jrgt
䅌	jrho
䡓	jrii
勌	jrjl
呟	jrky
臇	jrov
脧	jrow
罥	jrso
羂	jrso
䌸	jrsv
䚈	jrxe
㪻	jryu
熲	jsbb
㯋	jsbb
蘔	jscb
浻	jsdk
㓏	jsdk
烱	jshk
冋	jskk
煛	jsoh
煚	jsoh
㷡	jsoh
僒	jsrk
綗	jssk
㢠	jszk
䢛	jszk
瘚	jtbr
殌	jtdg
灍	jtdr
䦼	jteg
嶥	jter
撧	jtfb
捔	jtfy
挗	jtfy
刔	jtgd
彏	jtgy
爑	jthh
㷾	jthu
蹷	jtir
虳	jtiu
䡈	jtix
鈌	jtjg
鐍	jtjk
䦆	jtjy
駃	jtmg
㭈	jtmg
㭾	jtmi
欔	jtmy
鴃	jtng
䣤	jtoe
䀗	jtog
絶	jtsb
㔃	jtsd
矡	jtsy
䞷	jtti
埆	jtty
䞵	jtty
屫	jtuk
鶌	jtun
氒	jtuu
䝌	jtuy
㲄	jtuy
孒	jtva
貜	jtvy
䇶	jtvy
㸕	jtvy
憰	jtxk
㤜	jtxu
戄	jtxy
勪	jtyl
䠇	jtzi
逫	jtzy
躩	jtzy
䱟	juak
䱡	juam
痀	jubk
匊	jubm
䜯	jubm
寠	jubn
鵴	jubn
冣	juby
輂	juci
蘜	jucm
䕮	jucm
泦	judj
洰	judj
涺	judk
淗	judm
湨	judq
㪺	judu
巈	juem
㞫	juev
㩴	juff
拠	jufj
㨿	jufj
挶	jufk
㐝	jufv
䰬	jugk
㡹	jugq
爠	juhf
䵕	juhk
䅕	juhk
勮	juhl
䅓	juhy
鼰	jujb
䢹	juje
鉅	jujj
䳔	jujn
鼳	jujq
鐻	juju
乬	jujv
巪	jujv
㐦	jujv
㘌	jukd
㖩	juky
耟	julj
䎤	julk
䪕	julm
椇	jumb
粔	jumj
閰	jumj
駏	jumj
梮	jumk
駶	jumk
毩	jumm
椈	jumm
毱	jumm
粷	jumm
驧	jumm
﨔	jumu
欅	jumu
婅	junm
犑	junq
㜘	junq
䝻	juok
䏱	juok
鵙	juon
鶪	juon
䋰	juox
䪶	juqb
㹼	juqm
埧	jutb
㘲	jutj
趜	jutm
㽤	jutm
凥	juuj
㞐	juul
躹	juum
鶋	juun
䃊	juuq
簴	juvb
歫	juvj
䶙	juvj
艍	juvk
䈮	juvk
怇	juxj
怐	juxk
㥌	juxm
懅	juxu
䣰	juyj
䤎	juyk
䛯	juyk
蹫	juzk
跔	juzk
蹻	juzk
躆	juzu
戞	jxag
䕒	jxck
鵊	jxdn
抸	jxff
拁	jxfk
䩡	jxgr
麚	jxgy
㕅	jxij
徦	jxiy
頬	jxjb
鉫	jxjk
幏	jxju
唊	jxkr
嗧	jxlc
㚙	jxld
耞	jxlk
毠	jxlm
䂟	jxlu
乫	jxlv
㮖	jxmg
梜	jxmr
榢	jxmu
糘	jxmu
榎	jxmw
婽	jxny
犌	jxny
㹢	jxqk
猳	jxqy
斚	jxsu
貑	jxvy
玾	jxwj
䛟	jxyr
跲	jxzk
銞	jybj
汮	jydd
㴫	jyde
攈	jyfh
攟	jyfh
燇	jyhc
蚐	jyid
鍕	jyji
䜭	jylk
桾	jymk
鵔	jynw
袀	jypd
㑺	jyrn
㒞	jyrv
㑓	jyry
埈	jytw
碅	jyuh
䝍	jyui
箟	jyvb
皹	jyvi
䇹	jyvk
㻒	jywh
懏	jyxv
覠	jyye
𣓉	jpmr
𨟠	jtoe
擖	kaf
裃	kap
佧	kar
佧	karb
垰	kat
䘔	kaxk
鲓	kca
鯌	kcak
丂	kcav
薧	kccb
嵪	kcek
䎋	kcnx
䐧	kco
䯪	kcw
勓	kdbl
㪡	kdby
䒓	kdcv
颽	kdei
烗	kdhr
䡷	kdim
暟	kdoa
欬	kdwr
愙	kebx
薖	keck
萪	kecu
渇	kedb
㪼	kedj
㞹	keek
嵙	keeu
嶱	keev
揢	kefk
搕	kefm
敤	kegy
㕎	keim
钶	kej
娔	ken
犐	kenu
胢	keok
䐦	keom
唟	keos
䙐	kepl
樖	kerk
堁	ketg
砢	keuk
勊	keul
殻	keuy
䶗	kevk
艐	kevw
㤩	kewx
悈	kexc
醘	keym
趷	kezq
肎	kfbo
掯	kffo
錹	kfjo
肻	kflo
褃	kfpo
豤	kfug
貇	kfvg
龂	kfvj
珢	kfwg
㸧	kfyg
揁	kgfb
挳	kgfg
摼	kgft
㧶	kgfu
硻	kgi
䡩	kgib
鍞	kgjb
銵	kgju
㰢	kgkr
牼	kgng
妔	kgnj
䡰	kgui
䃘	kgut
劥	kgwl
誙	kgyg
㝩	khbn
㼹	khc
漮	khdn
嵻	khe
摃	khfb
㱂	khgr
㢜	khgx
穅	khhn
䗧	khi
鏮	khjn
匟	khkj
槺	khmn
嫝	khn
犺	khqj
砊	khuj
躿	khun
邟	khwe
忼	khxj
怾	kixb
輡	kjij
㘛	kjka
竷	kjlw
䳚	kjon
矙	kjow
歁	kjqr
偘	kjrk
顑	kjwb
鱠	kkao
蒉	kkcr
䓒	kkct
㟴	kkeg
擓	kkff
	kkfk
旝	kkfo
凷	kkkt
糩	kkm
侩	kkr
墤	kktb
㙕	kkto
圦	kktr
䈛	kkvy
贶	klb
㾠	klbw
䒰	klc
岲	klee
䯑	klgw
懬	klgx
穬	klhb
軠	klir
軭	kliw
鉱	kljs
䊯	klmb
眖	kloe
昿	klos
鵟	klqn
儣	klrb
㑌	klrw
絋	klss
絖	klsw
砿	klus
硄	klux
筺	klvy
懭	klxb
恇	klxw
鬠	koa
髺	koak
㾧	kob
葀	koc
漷	kod
拡	kofs
挄	kofw
鞹	koge
鞟	kogz
懖	kojx
㗥	kok
噋	kokw
䦢	koms
頢	koq
筈	kov
䟯	koz
䲌	kra
寛	krbe
欵	krbr
䕀	krc
鑧	krjd
䥗	krjr
歀	krm
梡	krme
㯘	krmr
臗	krod
鵼	ksbn
㲁	ksby
㚚	ksdk
鞚	ksgg
䅝	kshg
錓	ksjq
鞚	ksng
㸜	ksp
㤟	ksqx
矼	ksu
悾	ksxg
羫	ksyg
鮬	kua
䔯	kuck
㵠	kudi
崫	kuei
䧊	kuek
扝	kufk
廤	kugb
䯇	kugl
㐣	kugv
秙	kuhk
䵈	kuim
㠸	kujf
朏	kuo
袴	kupk
㩿	kuqw
俈	kurk
䂗	kuub
跍	kuz
䰎	kva
蒊	kvcb
藈	kvct
蘷	kvcw
殨	kvdb
㱮	kvdr
聧	kvet
巙	kvew
㨒	kvft
䯣	kvgb
䯓	kvgt
頄	kvjb
嘳	kvkb
㕟	kvly
犪	kvn
嬇	kvnb
媿	kvng
頯	kvpb
䙌	kvpr
䙆	kvpt
䧶	kvrb
㒑	kvrf
㙺	kvtb
刲	kvtd
䖯	kvti
㙓	kvtt
磈	kvug
籄	kvvb
䳫	kvvn
謉	kvyg
䤆	kvyt
尯	kvyv
蹞	kvzb
䟸	kvzc
躨	kvzw
穒	kweo
㐄	kxa
䓙	kxcb
顝	kxgb
骻	kxgk
骻	kxgv
咵	kxkv
䦚	kxmk
㛻	kxnt
晇	kxok
晇	kxov
䠸	kxuk
舿	kxvk
舿	kxvv
恗	kxxv
趶	kxzy
髨	kyae
髠	kyaj
菎	kycb
潉	kydb
涃	kydm
㩲	kyff
熴	kyhb
稛	kyhh
稇	kyhm
蜫	kyib
䖵	kyii
㡓	kyji
困	kyk
閸	kyma
騉	kymb
婫	kyn
䐊	kyob
㫻	kyoc
晜	kyop
祲	kyp
裩	kypb
祵	kypm
猑	kyqb
㱎	kysr
堒	kytb
壼	kyua
硱	kyum
瑻	kywb
尡	kyxb
䠅	kyzh
㰯	kza
窛	kzbn
冦	kzby
蔲	kzcw
滱	kzdy
彄	kzgk
竘	kzl
䳹	kzn
瞘	kzok
䁱	kzow
劶	kzp
瞉	kzuy
簆	kzvy
䯌	kcgj
髛	kcwj
奒	kddr
炏	kdhh
輆	kdir
鎎	kdjm
䤤	kdjr
䁗	kdoa
衉	kdxk
㚊	kdxr
痾	kebk
䆟	kebk
㝓	kebk
㵣	kedr
㐓	kedv
嵑	keev
㪙	kegw
㕉	keik
礊	keiu
榼	kemm
㸯	kenu
䌀	kesu
碦	keuk
勀	keul
礚	keum
厼	keum
䈖	kevu
翗	kexx
坈	kgtj
鱇	khan
䆲	khbn
䡉	khij
囥	khkj
粇	khmj
欿	kjdr
栞	kjgm
轗	kjix
䀍	kjlm
埳	kjtj
塪	kjtj
䖔	kjtj
㙳	kjtx
惂	kjxj
䘓	kjxj
廥	kkgo
䯤	kkgo
㔞	kkql
䭝	kkuo
巜	kkvv
抂	klfw
軦	klie
軖	kliw
䖱	kliw
鋛	klji
邼	klke
劻	klkl
匩	klkw
䵃	klmb
狅	klqr
黋	klxb
忹	klxw
䯺	koak
韕	kolz
桰	komk
霩	koye
窾	krbr
窽	krbr
躻	ksug
瘔	kubk
郀	kude
㱠	kudk
焅	kuhk
㗄	kukf
桍	kumk
狜	kuqk
㪂	kuqy
䇢	kuvk
䉐	kuvk
䕚	kvcb
蘬	kvcj
虁	kvcw
䕫	kvcw
聭	kveg
䫥	kvgb
鐀	kvjb
鑎	kvjb
鍷	kvjt
鍨	kvjt
欳	kvlr
樻	kvmb
楑	kvmt
楏	kvmt
晆	kvot
䙡	kvpr
頍	kvub
鄈	kvve
㚍	kvxb
䠑	kvzt
䯞	kxgk
銙	kxjk
㡁	kxjk
楇	kxmk
裍	kypm
䪲	kywb
宼	kzbn
㓂	kzbn
敂	kzbw
剾	kzkd
鷇	kzuy
䍍	kzuy
怐	kzxk
𩾌	kha_
𡐓	kht_
理	li
略	lt
鬎	laad
菈	lac
藞	lacu
溂	ladd
䏀	lae
揦	laf
攋	lafb
搚	lafo
㡴	lagl
爉	lahd
䗶	laiv
鑞	lajd
櫴	lamb
楋	lamd
柆	laml
臈	laov
䱫	laua
磖	laub
揧	lauu
瓎	lawb
㻝	lawd
䫰	lbal
冧	lbbl
癝	lbbx
䕲	lbch
菻	lbcm
澟	lbdh
瀶	lbdk
崊	lbem
撛	lbfl
㨆	lbfm
麐	lbgk
㷠	lbhl
轥	lbif
䫐	lbmb
䚏	lbme
斴	lbmj
亃	lbmv
甐	lbmw
晽	lbom
獜	lbql
僯	lbrl
繗	lbsl
綝	lbsm
厸	lbss
碄	lbum
懍	lbxh
恡	lbxs
躙	lbzf
鮱	lcab
䲏	lcal
䵏	lccp
䕩	lccx
㟹	lcee
㟉	lcen
㧯	lcfb
㨓	lcfn
䝁	lcha
蛯	lcib
蟧	lcil
轑	lcix
铹	lcj
咾	lckb
哰	lckn
䳓	lcln
粩	lcmb
橯	lcml
朥	lco
嗠	lcpk
㺐	lcqg
僗	lcrl
硓	lcub
磱	lcul
躼	lcun
䝤	lcvx
珯	lcwb
髝	lcwl
䜎	lcyl
鯠	lda
䲚	ldab
藾	ldcb
瀬	lddb
䧒	lder
㸊	ldhb
唻	ldkn
顂	ldmb
郲	ldme
鶆	ldmn
騋	ldmr
婡	ldnr
襰	ldpb
倈	ldrr
䋱	ldsr
頼	ldub
琜	ldwr
鱳	leam
艻	lec
氻	ledl
楽	ledm
阞	lee
扐	lefl
㖀	leky
韷	leli
牞	len
砳	leuk
㔹	leul
砳	leuu
竻	levl
玏	lew
忇	lex
㦡	lexm
薐	lgc
䬋	lgjw
㘄	lgkf
睖	lgo
倰	lgrw
碐	lguw
䉄	lgvw
踜	lgzw
䱶	lhae
㾿	lhbe
㝗	lhbl
蓈	lhce
勆	lhdl
欴	lhdr
䯖	lhgl
鎯	lhje
唥	lhks
郒	lhlb
郞	lhle
樃	lhmo
嫏	lhne
朖	lhol
朤	lhoo
䍚	lhsl
㙟	lhto
硠	lhul
誏	lhyl
鯏	liad
䣓	liae
鲤	liat
礼	liav
䰛	liaw
叓	liay
疠	lib
㿨	libv
蓠	lic
䕻	licb
䔉	lich
蔾	licm
䔣	licn
菞	licp
䓞	licq
莅	licw
沴	lidp
㽝	lidt
㻎	lidw
峲	lied
屴	liel
㟳	liem
㠟	lieu
㠣	liev
巁	liey
攦	lifb
攭	lifi
㧰	lifl
搮	lifm
攊	lifv
廲	ligb
䰜	ligg
瓥	ligi
麜	ligm
鯬	liha
䖿	lihi
䅄	lihl
蛎	lii
蟍	liim
暦	liio
蝷	liip
蜧	liiq
厘	liit
厯	liix
囇	likb
囄	likf
㗚	likm
㘑	likn
喱	likt
里	lil
鴗	lilh
粒	lim
枥	lim
梸	limd
㰚	limf
棙	limq
㯤	limr
栎	limy
孋	linb
娳	lind
犡	liny
㒿	lio
䤚	liol
曞	lioy
䙰	lipf
禲	lipy
豊	liqa
㺡	liqv
㑦	lirq
俚	lirt
䍦	lisf
䋥	lisl
綟	lisq
䍥	lisv
㔏	liud
砬	liul
䃯	lium
隷	liun
纚	livb
瑮	liwm
斄	liwr
瓑	liwv
裏	liwy
孷	liwz
悧	lixd
盭	liym
叕	liyy
䰐	lja
葻	ljci
蓞	ljcj
漤	ljd
㳕	ljds
㞩	ljef
顲	ljhb
厱	ljir
啉	ljk
囒	ljkj
嚂	ljkm
孏	ljnj
㜮	ljnm
暕	ljo
䑌	ljoj
儖	ljrm
繿	ljsm
壈	ljth
籣	ljvj
璼	ljwm
醂	ljym
譋	ljyo
魿	lkas
皊	lkbs
䕘	lkcb
蘦	lkck
䖅	lkcr
蓤	lkcw
㱥	lkdw
䧙	lkex
䍅	lkfs
掕	lkfw
爧	lkhr
秢	lkhs
䡼	lkik
䡿	lkir
輘	lkiw
錂	lkjw
㖫	lkkw
领	lkl
㸳	lkns
婈	lknw
昤	lko
朎	lkos
䄥	lkpr
袊	lkps
狑	lkqs
刢	lkrd
夌	lktw
砱	lkus
䉹	lkvr
䈊	lkvw
㻏	lkwh
琌	lkwv
龗	lkya
䰱	lkyg
孁	lkyn
跉	lkzs
両	lla
㔝	llal
㾗	llbl
䓣	llcr
掚	llfr
喨	llkj
唡	llkl
樑	llm
㹁	lln
䀶	llol
脼	llor
裲	llpr
緉	llsr
簗	llvm
䠃	llzr
鰊	lmaj
莶	lmca
萰	lmcj
薕	lmcn
蘝	lmcr
㶌	lmdl
澰	lmdr
聨	lmec
聫	lmed
聮	lmeh
䏈	lmex
鄻	lmfe
摙	lmfi
劆	lmgd
㼓	lmgn
熑	lmhn
㼑	lmjg
錬	lmjo
嗹	lmki
噒	lmkl
櫣	lmmi
㯬	lmmy
嬚	lmn
媡	lmnj
㜃	lmnk
嫾	lmnl
㜻	lmnx
臁	lmon
縺	lmsi
䌞	lmsr
纞	lmsx
堜	lmtj
籨	lmvr
亷	lmwn
䨬	lmym
㦁	lmzx
镽	lnax
窷	lnbe
尦	lnbu
䨅	lndf
嵺	lnep
嶛	lnex
膋	lnho
炓	lnhu
蟟	lni
敹	lnlw
䉼	lnmj
樛	lnmp
賿	lnop
暸	lnox
爒	lnp
㙩	lnt
屪	lnux
䑠	lnvl
璙	lnwx
鄝	lnxe
䎆	lnxs
䜍	lnyx
蹘	lnzp
鮥	loa
覼	loae
癳	lobx
㱻	lodf
㴖	lodg
峈	loe
镙	lojx
囖	lokf
剆	lold
䯁	lomf
曪	loof
䀩	look
覶	lope
㑩	lorx
䉓	lovg
笿	lovk
蠃	low
㓢	lowd
䊨	lowj
鵅	lown
䎊	lowx
㦬	loxf
㞅	loyg
㽋	loyw
鱲	lpad
鬛	lpav
䜲	lpbd
茢	lpc
鮤	lpda
烮	lpdh
洌	lpdl
㤠	lpdx
峢	lped
聗	lper
㼲	lpew
挒	lpfd
㧜	lpfj
挘	lpfl
䪉	lpgd
䅀	lphd
蛚	lpi
颲	lpjd
哷	lpkc
烈	lpl
㭞	lpm
㭩	lpmc
㲱	lpmd
㸹	lpnc
犣	lpnd
䁽	lpod
㬯	lpof
睙	lpoq
儠	lpr
䋑	lps
䝓	lpud
毟	lpum
巤	lpvd
煭	lpvh
巤	lpvv
䟹	lpzc
䟩	lpzs
䱞	lqa
䱖	lqaa
鬸	lqat
蒥	lqct
蓅	lqcv
鎏	lqd
漻	lqdp
嵧	lqet
㧕	lqfe
飅	lqft
旈	lqfv
廇	lqgt
熮	lqhp
蟉	lqip
䗜	lqit
䬟	lqjd
嚠	lqk
羀	lqkt
栁	lqme
骝	lqml
嬼	lqnd
媹	lqnt
裗	lqpv
䄂	lqpy
磟	lqup
䉧	lqvd
䰘	lqwp
瑠	lqwt
懰	lqxd
雡	lqxf
㽌	lqyw
癵	lrbr
虊	lrcm
䖂	lrcu
圞	lrkm
圝	lrkx
羉	lrsx
挛	lrw
奱	lryd
曫	lryo
㱍	lryr
灓	lryu
㝈	lryz
豅	lsba
蕯	lscu
㳥	lsdc
滝	lsdd
㙙	lsdt
巃	lsea
㟖	lsec
屸	lseg
嶐	lseu
䪊	lsga
㢅	lsgc
爖	lsha
蠬	lsia
鑨	lsja
蠪	lsli
驡	lslm
鸗	lsln
竜	lslv
龒	lslx
䙪	lsmy
㛞	lsnc
曨	lsoa
襱	lspa
儱	lsra
㑝	lsrc
壠	lsta
礲	lsua
硦	lsuc
尨	lsud
鏧	lsuj
篢	lsvb
篭	lsvd
珑	lsw
躘	lsza
㗉	ltfk
鋢	ltjz
㔀	lto
寽	ltpc
㑼	ltrk
畧	lttk
䌎	lttx
魲	luah
䲐	lual
䰕	luam
鯥	luat
蓾	luca
蔍	lucb
淕	ludt
陆	lue
㠠	luem
䎼	lueu
峍	luey
摝	lufb
捛	lufk
攎	lufm
廘	lugb
㢚	lugl
髗	lugm
㢳	lugn
㼾	lugw
熝	luhb
黸	luhm
㪐	luhy
蠦	luim
鏀	luja
鏕	lujb
鈩	lujh
嚧	lukm
㖨	luku
樐	luma
㯭	luml
䮉	lumn
㜙	lunb
鴼	lunk
㛬	lunt
膔	luob
矑	luom
睩	luou
䘵	lupu
侓	lury
䍡	lusb
纑	lusm
塷	luta
塶	lutb
圥	lute
勎	lutl
坴	lutt
磠	luua
䃙	luub
硵	luux
硉	luuy
录	luv
簏	luv
簬	luvk
舻	luvl
瓐	luwm
玈	luwn
蹗	luzb
踛	luzt
㾔	lvbk
䕡	lvck
䔞	lvcu
藘	lvcx
㠥	lvet
嵂	lvey
膐	lvfr
勴	lvhl
鷜	lvln
馿	lvmh
闾	lvml
㭚	lvmn
櫖	lvmx
㛎	lvnk
曥	lvom
膢	lvon
寽	lvpc
祣	lvpn
㲶	lvqa
儢	lvrx
絽	lvsk
緑	lvsu
㻲	lvwn
鱩	lwat
癗	lwb
㿔	lwbt
蘱	lwcb
䒹	lwcl
蘽	lwcm
蕌	lwco
蔂	lwcx
涙	lwdd
洡	lwdl
灅	lwdt
㴃	lwdu
㶟	lwdx
攂	lwft
蠝	lwit
銇	lwjl
錑	lwjq
頛	lwlb
㼍	lwlg
頪	lwmb
䮑	lwmc
颣	lwmr
櫑	lwmt
樏	lwmx
㹎	lwnx
脷	lwod
䐯	lwox
矋	lwoy
禷	lwpb
㲕	lwpm
㑍	lwrl
傫	lwrx
厽	lwss
䍣	lwst
㔣	lwtl
櫐	lwtm
畾	lwtt
纍	lwtx
磥	lwux
䉪	lwvt
䉂	lwvx
瓃	lwwt
䨓	lwyk
䛶	lwym
䢮	lwzt
鯩	lya
崘	lyec
稐	lyhc
蜦	lyic
錀	lyjc
㖮	lykc
耣	lylc
棆	lymc
婨	lync
腀	lyo
埨	lytc
䑳	lyvc
惀	lyxc
踚	lyzc
䱾	lzan
廔	lzgn
熡	lzhn
㔷	lzkb
䫫	lzlb
㪹	lzlu
甊	lzlw
瞜	lzon
	lzov
䄛	lzpn
㺏	lzqn
塿	lztn
軁	lzun
屚	lzuy
艛	lzvn
慺	lzxn
謱	lzyn
遱	lzzn
鯻	laad
䱨	laad
䶛	ladr
蝋	lail
㕇	lail
嚹	lakh
䓥	laru
䂰	laud
䃳	laud
辢	lauu
㻋	lawu
翋	laxl
癛	lbbh
痳	lbbm
㝝	lbbm
䚬	lbdl
䗲	lbil
鏻	lbjl
㖁	lbks
㔂	lbmd
閵	lbmf
焛	lbmh
橉	lbml
驎	lbml
䮼	lbml
暽	lbol
疄	lbtl
壣	lbtl
䉮	lbvf
㐭	lbwk
悋	lbxk
惏	lbxm
蹸	lbzl
䢯	lbzl
窂	lcbn
浶	lcdn
䃕	lchu
憥	lchx
㗦	lcke
㐗	lclv
狫	lcqb
軂	lcul
㞠	lcux
䇭	lcvb
簩	lcvl
恅	lcxb
顟	lcxb
労	lcxl
憦	lcxl
䓶	ldcd
㚓	lddm
庲	ldgr
䅘	ldhr
㥎	ldhx
䚅	ldme
棶	ldmr
麳	ldmr
䄤	ldpb
猍	ldqr
鵣	ldun
䂾	ldur
筙	ldvl
箂	ldvr
䠭	ldzb
逨	ldzr
䮚	lgmw
䆡	lhbl
䕞	lhcl
㱢	lhdl
㟍	lhel
㢃	lhgl
蜋	lhil
䡙	lhil
駺	lhml
躴	lhul
艆	lhvl
䲞	lial
鱱	liay
㿛	libb
㾐	libd
㾖	libl
皪	libm
茘	licd
蒚	licg
苙	licl
荲	licl
䔆	licl
䔁	licm
䔧	licm
刕	lidd
㡂	lidj
㱹	lidv
濿	lidy
岦	liel
䧉	liel
㼖	ligi
䱘	liha
穲	lihb
剓	lihd
䅻	lihd
秝	lihh
䵩	lihh
䖽	lihi
鋫	lihj
錅	lihj
棃	lihm
䊍	lihm
犂	lihn
鵹	lihn
䵓	lihn
睝	liho
㴝	lihu
爏	lihv
䴻	lihw
悡	lihx
爄	lihy
蚸	liii
蛠	liil
䘈	liil
䡃	liil
磿	liiu
轣	liiv
㽁	liiw
蠇	liiy
㻺	liiy
䬆	lijd
鉝	lijl
䬅	lijl
鏫	lijm
鑗	liju
䥶	lijv
唎	likd
㕸	likl
䚕	lile
竰	lill
㮚	lilm
婯	liln
欐	limb
樆	limd
䮋	limd
欚	limi
糎	liml
粴	liml
栛	liml
檪	limm
栃	limw
櫔	limy
䊪	limy
鳨	linl
㛤	linl
㬏	liol
褵	lipd
䄜	lipd
㒧	lirf
儮	lirv
䍠	lisd
䖥	lisi
赲	litl
塛	litm
䟏	litm
䟐	litv
蟸	liui
砅	liuu
礰	liuv
筣	livd
劙	livd
㓯	livd
蠫	livi
䗍	livi
艃	livl
䶘	livl
盠	livm
䉫	livu
甅	liwa
瓼	liwa
剺	liwd
瓅	liwm
㹈	liwn
瓈	liwu
㤡	lixd
㦒	lixk
㤦	lixl
鷅	lixn
悷	lixq
㸚	lixx
謧	liyd
䤙	liyi
讈	liyv
靋	liyv
䍽	liyv
䣫	liyy
邌	lizu
迣	lizu
䆾	ljbm
灠	ljde
灡	ljdj
㱫	ljdj
灆	ljdm
浨	ljdm
㩜	ljfm
㨫	ljfm
韊	ljgj
䪍	ljgj
爦	ljhe
燣	ljhh
爤	ljhj
爁	ljhm
燗	ljho
燷	ljhx
覧	ljie
擥	ljiu
钄	ljjj
㘓	ljkj
㰖	ljme
欗	ljmj
糷	ljmj
䦨	ljmo
孄	ljnj
㛦	ljnm
襽	ljpj
㑣	ljrm
䌫	ljse
䍀	ljsm
壏	ljtm
䃹	ljuj
礷	ljum
瓓	ljwj
㦨	ljxj
惏	ljxm
懢	ljxm
㾉	lkbs
蕶	lkcs
䔖	lkcw
瀮	lkdm
岺	lkes
阾	lkes
麢	lkgk
䴫	lkgs
䯍	lkgs
㡵	lkgs
炩	lkhs
燯	lkhs
衑	lkii
彾	lkis
軨	lkis
竛	lkls
鹷	lkls
駖	lkms
閝	lkms
㯪	lkms
㬡	lkos
䙥	lkps
裬	lkpw
紷	lkss
䌢	lkss
䠲	lkus
㲆	lkus
笭	lkvs
齢	lkvs
䉖	lkvs
䉁	lkvs
㦭	lkxr
䚖	lkye
霝	lkyk
醽	lkyk
䴒	lkyn
䴇	lkyn
詅	lkys
霗	lkys
䨩	lkyu
霊	lkyy
㪮	lkyy
湸	lldj
䩫	llgr
煷	llhj
輌	llie
蜽	llir
鍄	lljx
哴	llkl
䝶	llox
䁁	llox
綡	llsx
䭪	llul
䣼	llyx
鬑	lman
㝺	lmbu
湅	lmdj
濓	lmdn
溓	lmdn
㶑	lmdr
㱨	lmdr
覝	lmge
䙺	lmhe
㟀	lmhe
燫	lmhn
稴	lmhn
䆂	lmhn
㥕	lmhx
螊	lmin
鎌	lmjn
㡘	lmjn
㪝	lmjy
槤	lmmi
㰈	lmmi
㜕	lmni
䁠	lmon
㺦	lmql
僆	lmri
㰸	lmrr
㪘	lmrw
䃛	lmui
䭑	lmun
慩	lmxi
翴	lmxi
謰	lmyi
羷	lmyr
蹥	lmzi
㝋	lnbl
䜮	lnbn
豂	lnbp
竂	lnbx
䒿	lnco
㶫	lndh
㵳	lndp
尞	lndx
嶚	lnex
㡻	lnge
廫	lngp
䄦	lnhl
爎	lnhx
飉	lnjx
䩍	lnmx
膫	lnox
憀	lnxp
䢧	lnzp
㿚	lobf
㩡	lofu
㰁	lomu
頱	lopb
㒩	lori
纙	losf
䌴	losf
䌱	losf
饠	louf
躶	loug
䈷	lovk
鸁	lowf
䇔	lowf
㼈	lowf
㪾	lowj
洜	lowu
浖	lpdc
劽	lpdl
姴	lpdn
鴷	lpdn
擸	lpfd
㯿	lpmd
栵	lpmd
猟	lpql
埓	lptc
㽟	lptc
䉭	lpvd
迾	lpzd
鰡	lqat
䝀	lqat
癅	lqbt
藰	lqcd
䚧	lqdp
澑	lqdt
沠	lqdv
麍	lqgv
㶯	lqhe
飂	lqjp
鐂	lqjt
㽞	lqkt
駵	lqma
桺	lqma
橮	lqmb
桞	lqme
駠	lqme
橊	lqmt
驑	lqmt
㙀	lqtj
塯	lqtt
磂	lqut
璢	lqwt
㐬	lqwv
翏	lqxp
畄	lqxt
蹓	lqzt
癴	lrbu
釠	lrjj
鵉	lrwn
㡩	lryj
䜌	lryx
竉	lsba
㝫	lsbu
㴳	lsdd
湰	lsdu
巄	lsea
䏊	lsea
䃧	lseu
䆍	lsha
徿	lsia
㰍	lslm
䮾	lsma
梇	lsmc
槞	lsmd
矓	lsoa
贚	lsoa
龓	lsua
䡁	lsua
䥢	lsuj
㚅	lswu
㦕	lsxu
靇	lsya
霳	lsyu
䛚	ltfk
擽	ltfm
稤	lthx
䤣	ltjh
㨼	lttu
䱚	luau
㔪	luba
㿖	lubm
虂	luck
觻	ludm
㱺	ludm
瀂	ludo
㓐	ludt
觮	ludu
㟤	lueu
挔	lufy
䴪	lugu
䩮	lugu
穋	luhp
㪭	luhy
螰	luib
䡎	luih
䡜	luit
鏴	lujk
鐪	lujl
錴	lujt
録	luju
樚	lumb
騼	lumb
枦	lumh
㭔	lumh
㯝	lumk
椂	lumu
粶	lumu
騄	lumu
㯟	lumu
娽	lunu
鵦	lunu
膟	luou
䐂	luou
㫽	luou
獹	luqm
䌒	lusb
鵱	lutn
趢	lutu
䚄	luve
舮	luvh
簵	luvk
盝	luvm
籚	luvm
彔	luvu
簶	luvu
㪖	luvy
璷	luww
㦇	luxb
剹	luxd
䎑	luxu
醁	luyu
䟿	luzu
焒	lvhk
㔧	lvhl
穞	lvho
爈	lvhx
䥨	lvjk
鑢	lvjx
哷	lvkc
郘	lvke
氀	lvlm
繂	lvsu
箻	lvvy
蘲	lwct
虆	lwcx
㵢	lwdt
㵽	lwdt
轠	lwit
鼺	lwjt
鑘	lwjt
鑸	lwjt
䣂	lwle
欙	lwmx
㒦	lwrt
儽	lwrx
㒍	lwrx
絫	lwsx
纝	lwsx
鸓	lwtn
䴎	lwtn
壨	lwtt
塁	lwtt
㙼	lwtt
礨	lwtu
礧	lwut
䣦	lwyl
靁	lwyt
讄	lwyt
菕	lycc
溣	lydc
陯	lyec
㷍	lyhc
碖	lyuc
磮	lyuc
䈁	lyvc
㟺	lzen
鞻	lzgn
䅹	lzhn
㡞	lzjn
䣚	lzle
㲎	lzmm
䮫	lzmn
䝏	lzun
㥪	lzxn
𨈓	lgux
𦝼	lvo_
蒙	mg
莫	mo
鬕	maa
鰢	maam
痲	mabe
蔴	mac
䧞	maem
㨸	mafe
犘	magn
鎷	majm
唛	makw
唜	mamb
䣕	mame
閁	mamp
匁	mang
㜫	manw
睰	mao
亇	mapl
㑻	mar
傌	marm
遤	mazm
䲄	mba
痻	mbbo
潣	mbdw
崏	mbeo
㞶	mbew
捪	mbfo
䡻	mbif
䡑	mbim
錉	mbjo
刡	mbmd
㟩	mbme
蠠	mbmi
鴖	mbmn
敯	mbmy
姄	mbnm
䝧	mbod
䁕	mboo
旼	mbow
賯	mboz
勄	mbpl
僶	mbra
罠	mbsm
䂥	mbum
砇	mbuw
笽	mbvm
琘	mbwo
怋	mbxm
惽	mbxo
䟨	mbzm
髳	mcap
㒵	mcbb
皃	mcbe
蓩	mccl
鶜	mccn
萺	mcco
䓮	mccw
㴘	mcdo
渵	mcdt
䅦	mcht
䡚	mcie
軞	mcim
蝐	mcio
㡌	mcjo
毷	mckm
㪞	mcky
覒	mcme
毝	mcmp
媢	mcno
冐	mcoo
㫯	mcow
乮	mcpv
蟊	mcs
䋃	mcsm
堥	mcst
愗	mcsx
䫉	mcvb
戼	mcvv
瓱	mcwm
夘	mcxe
䀤	mcxo
酕	mcym
蕒	mdcb
薶	mdcl
嘪	mdkb
䮮	mdmw
㜥	mdnb
䁲	mdob
佅	mdrw
鷶	mds
䚑	mdse
㦟	mdvx
䘑	mdxy
霢	mdyn
䨫	mdyw
濹	medt
庅	megm
庅	megs
嚰	mek
嚒	meks
嚜	mekt
嚰	meku
嚒	meky
虋	mfcd
菛	mfcm
㱪	mfdo
汶	mfdw
鞔	mfg
閅	mfmd
䊟	mfmr
暪	mfo
䫒	mfub
玣	mfwb
玧	mfwe
璊	mfwr
悗	mfxe
惛	mfxo
鯭	mga
䲛	mgao
鯍	mgav
鼆	mgba
癦	mgbt
冡	mgbu
㝱	mgbx
顭	mgcb
鄸	mgce
莔	mgck
氋	mgcm
䠢	mgcr
蕄	mgcx
溕	mgdu
㩚	mgfn
庬	mggd
瓾	mghw
蟒	mgic
䥂	mgju
梦	mgl
䵆	mgmn
嫇	mgnb
䴌	mgnn
㜴	mgno
䏵	mgod
䁅	mgom
矒	mgoo
曚	mgou
䑅	mgox
䙩	mgpn
䙦	mgpx
儚	mgrx
罞	mgsp
甿	mgtw
㙹	mgtx
蝱	mgwi
夣	mgwx
靀	mgyn
霿	mgyo
孟	mgz
䟥	mgzp
㝑	mhbf
䒎	mhcb
䓼	mhcd
蘉	mhcy
浝	mhdd
汒	mhdw
㟿	mhec
㟌	mhed
㟐	mhew
䵨	mhhd
䅒	mhhw
蠎	mhic
铓	mhjv
釯	mhjw
哤	mhk
茻	mhkl
杧	mhm
䙪	mhmy
盳	mho
㬒	mhoc
硥	mhup
䈍	mhvo
笀	mhvw
䖟	mhwi
吂	mhwk
㤶	mhxd
䱊	mia
镾	miax
枈	mibm
㫘	mibo
鼏	mibv
葞	mice
藌	mici
蒾	micm
䕷	micx
灖	midf
濗	midj
㳴	midt
沕	midw
沵	midx
㟜	mie
㠧	mief
峚	miet
㨠	mifb
擟	mifx
㜷	mign
瓕	migy
熐	mihb
蝆	miil
麊	mimb
樒	mime
䊳	mimf
㐘	mimv
孊	minf
㜆	minm
眫	miob
㸓	mipo
侎	mir
䍘	mism
塓	mitb
幦	miuj
䭧	miux
䈿	mivb
簚	mivj
䉲	mivx
㥝	mixe
戂	mixf
釄	miyf
䣾	miyq
䛧	miyv
醿	miyx
䰋	mjan
䯶	mjaq
鬗	mjar
䜱	mjby
䒥	mjcj
蔄	mjck
蘰	mjcy
澷	mjdf
摱	mjfy
熳	mjhy
蟃	mjiy
㡢	mjjf
㗈	mjkl
樠	mjmr
槾	mjmy
姏	mjng
㒼	mjnr
㛧	mjnu
鄤	mjoe
㬅	mjof
䐽	mjor
睌	mjov
襔	mjpr
獌	mjqy
㙢	mjtr
䝡	mjvr
悗	mjxe
慲	mjxr
悗	mjxv
矕	mjyo
㝠	mkbb
鄍	mkbe
㟰	mkeb
掵	mkfe
朙	mkko
榠	mkmb
嫇	mknb
姳	mknk
眳	mkok
暝	mkol
	mkon
眀	mkoo
佲	mkrk
䰓	mmaf
芇	mmc
䏃	mmeb
麺	mmfm
㨺	mmfr
蝒	mmim
喕	mmkm
䩄	mmme
麫	mmmg
檰	mmmj
㰃	mmmx
婂	mmnj
媔	mmnm
矈	mmof
矊	mmoj
眄	mmov
㒙	mmrj
俛	mmrv
絻	mmsv
㻰	mmwe
悗	mmxe
䤄	mmym
䫵	mmzb
臱	mmzf
鱙	mna
庿	mngt
嫹	mnnb
媌	mnnt
䁧	mnof
㑤	mnrt
仯	mnru
㦝	mnvx
末	moa
魹	moam
魩	moaw
瘼	mob
劰	mobl
茉	moc
蘑	mock
䒬	mocx
莈	mocy
歾	modw
磨	mogk
㷵	mohh
爅	moht
蛨	moib
蟔	moih
䘃	moit
嗼	mokd
䮬	momd
橅	momh
暯	mood
昩	moom
眽	moon
瞐	mooo
䁼	moot
袹	mopb
㹮	moqb
絈	mosb
縸	mosd
纆	most
圽	motw
砞	moum
怽	moxw
鱴	mpa
覕	mpb
鴓	mpbn
薎	mpcg
瀎	mpdu
㩢	mpfu
蠛	mpi
蠛	mpiu
哶	mpkg
吀	mpkq
櫗	mpmu
䁾	mpo
㒝	mpr
䌩	mps
䈼	mpve
烕	mpwh
懱	mpxu
孭	mpz
㾇	mubo
㣎	mubp
暮	muc
莯	mucm
峔	mueb
㟂	muem
㧅	mufd
炑	muhm
蚞	muim
䥈	mujc
氁	mumd
胟	muom
獏	muqd
䱯	musa
鞪	musg
楘	musm
㜈	musn
墲	muth
坶	mutm
畒	muwr
畆	muws
慔	muxd
霂	muym
䜸	mwam
美	mwb
苺	mwcm
浼	mwd
沬	mwdw
嵄	mwed
挴	mwfm
旀	mwfx
穈	mwgh
鬽	mwgp
塺	mwgt
黣	mwhm
蝞	mwio
徾	mwiw
嚜	mwkt
呅	mwkw
媺	mwnw
脄	mwoh
脢	mwom
睸	mwoo
眛	mwow
祙	mwpw
猸	mwqo
睂	mwro
䍙	mwsm
珻	mwwm
㺳	mwwy
跊	mwzw
椧	myeo
䱕	mza
洠	mzdn
蟱	mzih
䗋	mzim
鉾	mzjn
桙	mzmn
䏬	mzon
劺	mzsl
䍒	mzsm
鴾	mzsn
堥	mzst
敄	mzsw
䋷	mzsx
鞪	mzxg
恈	mzxn
踎	mzzk
㾺	mabm
蟇	maci
溤	madm
䳸	magn
䯦	magu
㦄	magx
䗫	maim
䣖	mamb
嫲	manm
鷌	manm
禡	mapm
㐷	marm
礣	mauu
冺	mbdm
㟭	mbeo
㨉	mbfo
鈱	mbjm
鍲	mbjo
䪸	mbmb
暋	mbmo
敃	mbmw
㥸	mbmx
㬆	mboo
盿	mbow
䋋	mbsm
垊	mbtm
䃉	mbuo
笢	mbvm
簢	mbvw
琝	mbww
㝟	mcbe
㿞	mcbm
㧇	mcfa
㧌	mcfm
冃	mcke
枆	mcmm
䭷	mcmm
㮘	mcmw
㚹	mcne
㒻	mcoe
鄮	mcpe
暓	mcso
緢	mcst
笷	mcve
㲠	mcwm
㺺	mcwo
売	mdue
衇	mdxn
䨪	mdyl
霡	mdyy
䜕	mdyy
㵍	mfdx
穈	mfgh
椚	mfmm
怋	mfxm
㥃	mfxm
㦖	mfxx
䰒	mgan
䀄	mgbm
䒐	mgcb
䓝	mgcm
萠	mgco
掹	mgfm
䗈	mgio
䥰	mgji
鄳	mgle
䇇	mglm
橗	mgmo
䴿	mgmu
䑃	mgon
饛	mgun
䉚	mgvw
懜	mgxx
䤓	mgyn
雺	mgyp
霥	mgyu
痝	mhbd
莾	mhcc
蛖	mhid
㡛	mhjv
鋩	mhjw
駹	mhmd
娏	mhnd
䁳	mhoc
狵	mhqd
壾	mhuj
杗	mhwm
㻊	mhwv
恾	mhxw
鸍	mian
宻	mibe
冞	mibm
㝥	mibm
䁇	mibo
蔤	mice
蔝	micm
䕳	micx
淧	midb
㵋	midb
滵	mide
漞	mide
渳	mide
㴵	midm
㳽	midx
攠	miff
麛	mige
爢	migh
㸏	migh
䥸	migj
䴢	migm
㣆	migy
䖑	miho
幎	mijb
銤	mijm
䮭	mime
粎	mimi
櫁	mimi
榓	mimm
瞇	miom
袮	mipx
䌐	mise
䌏	mise
羃	misj
䌕	mism
䋛	mism
覛	mive
䛑	miyb
詸	miym
䤉	miym
䤍	miyr
䕕	mjcy
満	mjde
澫	mjdy
䅼	mjhy
䡬	mjiy
鏋	mjjr
䊡	mjmy
僈	mjry
絻	mjsv
䟂	mjty
㵘	mjuu
屘	mjuz
䝢	mjvy
䛲	mjyj
䫤	mkbb
䒌	mkbb
䆩	mkbd
覭	mkbe
凕	mkdb
䊅	mkmk
㫥	mkok
䳟	mkon
䄙	mkpb
猽	mkqb
慏	mkxb
詺	mkyk
鮸	mmav
㝰	mmbf
葂	mmcl
㴐	mmdm
汅	mmdv
櫋	mmmf
糆	mmmm
㮌	mmmm
嬵	mmnj
矏	mmof
䀎	mmov
㤁	mmtx
䃇	mmuj
䛉	mmym
㝃	mmzv
䖢	mniu
竗	mnlu
篎	mnvu
玅	mnwu
䱅	moam
皌	mobm
㱳	mocd
謩	mock
擵	mofu
劘	mogd
䯢	mogg
麿	mogk
髍	mogm
㷬	mohd
㶬	mohm
䁿	moho
㱄	mohr
帞	mojb
銆	mojb
帓	mojm
嚩	mokc
嚤	moku
黙	molh
粖	momm
枺	momm
䴲	momm
䩋	momm
嫼	monh
妺	monm
瞙	mood
眜	moom
䏞	moom
䳮	moon
眿	mooy
塻	motd
䭩	mouf
䃺	mouf
䬴	moum
礳	mouu
貃	movb
懡	moxm
䘊	mpiu
幭	mpju
鑖	mpju
䩏	mpmu
幙	mujd
凩	mujm
鉧	mujm
樢	mumn
牳	munm
娒	munm
䀲	muom
狇	muqm
縸	musd
䊾	musm
畮	mutm
畞	muuj
砪	muum
艒	muvo
䑵	muvo
毣	muxm
雮	muym
踇	muzm
痗	mwbm
䓺	mwcd
蘪	mwcm
葿	mwco
䰪	mwdg
湈	mwdm
凂	mwdv
攗	mwfm
抺	mwfw
䰨	mwgo
䆀	mwhh
煝	mwho
燘	mwhw
䵢	mwhw
韎	mwlm
栂	mwmm
楳	mwmm
䊈	mwmm
㭑	mwmw
嬍	mwnw
腜	mwom
矀	mwow
䀛	mwow
禖	mwpm
毎	mwpw
㙁	mwtm
堳	mwto
篃	mwvo
䉋	mwvo
䤂	mwym
麰	mzmn
㭌	mzmn
䥐	mzsj
魶	naa
蒳	nacn
䫱	naeb
㨥	nafn
靹	nagn
䖧	naid
䖓	naij
軜	nain
镎	naj
妠	nann
拏	nanu
䏧	naox
豽	navn
䇱	navw
䎎	naxv
䟜	nazn
拰	nbfr
拰	nbft
囜	nbks
脌	nbo
脌	nbol
䋻	nbsg
㤛	nbxr
夒	nca
匘	ncbx
巎	nce
㞪	ncee
嶩	ncen
桡	ncm
㛴	ncnx
脳	ncok
獿	ncqw
㺁	ncqx
㑎	ncre
䴃	nctn
堖	nctx
碙	ncue
䃩	ncun
憹	ncxn
怓	ncxy
詉	ncy
䛝	ncye
䜧	ncyv
譊	ncyw
䯮	nda
㾍	ndbe
渿	nddx
摨	ndfn
釢	ndjn
錼	ndjx
㲡	ndmm
㮈	ndmx
㜨	ndnn
腉	ndo
倷	ndrx
熋	ndsh
螚	ndsi
孻	ndzm
抐	nef
抐	nefn
䅞	nehc
䭆	nei
䎪	nelc
㕯	nen
眲	neo
眲	neoe
莻	neus
㶧	nfhn
㯎	nfmm
媆	nfn
嫰	nfnr
㴰	ngdb
鬞	nhan
嚢	nhay
涳	nhdg
瀼	nhdy
搑	nhfe
擃	nhfy
蠰	nhi
欜	nhm
䁸	nhon
儾	nhry
㚂	nhty
乪	nhvt
痆	nibb
苨	nicb
淣	nide
㵫	nido
埿	nidt
㞾	nieb
聣	niee
隬	niex
掜	nife
㫉	nifv
秜	nihb
䵑	nihr
蚭	niib
蜺	niie
郳	nije
㪒	nijy
䘌	niki
㕶	nikw
柅	nimb
棿	nime
籾	nimr
檷	nimx
臡	ninr
妳	ninx
䁥	niok
䘽	nipe
狔	niqb
㹸	niqe
儗	nirr
㲻	niru
伱	nirx
縌	nisp
堄	nite
惄	niux
䝚	nivb
愵	nixd
跜	nizb
莮	njcl
䔜	njcr
湳	njdg
抩	njfr
煵	njhg
囝	njkz
柟	njmr
娚	njnl
戁	njnx
㫱	njod
㬮	njof
暔	njog
䶲	njra
㽖	njtl
諵	njyg
遖	njzg
鬡	nka
寕	nkbd
寜	nkbl
寍	nkbm
鸋	nkbn
寗	nkbr
䆨	nkbt
㝕	nkby
苧	nkc
薴	nkcd
䔭	nkcy
澝	nkdy
䗿	nkid
鑏	nkjd
橣	nkmy
嬣	nkn
矃	nko
儜	nkrd
侫	nkrn
㿦	nkub
䭢	nkud
䖆	nlcy
䧔	nle
嬢	nlny
醸	nlyy
鲶	nma
淰	nmdx
䄭	nmhq
哖	nmkl
㮟	nmmm
姩	nmnl
㜤	nmnu
鵇	nmpn
䬯	nmuk
㞋	nmuy
艌	nmvx
䚓	nmxe
蹨	nmzh
躎	nmzx
䦊	nna
茒	nnce
㳮	nndu
㠡	nne
㭤	nnm
樢	nnmn
㒟	nnry
㞙	nnuu
䃵	nnuy
褭	nnwy
毭	noa
䚥	nodd
搦	nof
掿	nofk
穤	noh
稬	nohd
㐡	nojd
鍩	nojk
㡅	nojx
㖠	nokx
榒	nomd
梛	nome
㰙	nomf
橠	nomy
㔮	nonb
㑚	nore
搻	noru
郍	nov
懧	noxd
逽	nozk
䯵	npa
㜸	npcn
㚔	npdg
㴪	npdm
巕	npen
嶭	npeu
摄	npf
㩶	npfx
䡾	npi
钀	npjq
㡪	npjw
錜	npjx
蠥	npki
噛	npkm
囓	npkr
㖏	npkt
㖕	npku
孼	npkz
㖖	nplk
枿	npm
䯀	npme
闑	npmm
䯅	npmy
䳖	npn
圼	npo
䄒	nppx
敜	nprw
䌰	npse
䌜	npsw
槷	nptm
㘨	nptn
㘿	nptt
摰	nptu
䂼	npux
帇	npvj
篞	npvt
籋	npvx
讘	npye
踂	npzv
踗	npzx
踙	npzy
䒜	nqc
莥	nqci
靵	nqgi
炄	nqhi
㖻	nqkm
㚼	nqnt
䏔	nqo
䂇	nqsi
䋴	nqsm
㺲	nqwi
怓	nqxy
渜	nrdd
湪	nrdu
煗	nrhd
奻	nrn
奻	nrnn
㬉	nrod
餪	nrrd
农	nsb
癑	nsbn
蕽	nsc
浓	nsd
挵	nsfc
挊	nsfx
㶶	nshn
䢉	nsjn
欁	nsmm
襛	nspn
㺜	nsqn
繷	nssn
醲	nsyn
齈	nsz
䖈	nth
䖋	nthr
婩	ntn
硸	ntug
䨋	ntyq
搙	nufc
努	nun
㐐	nunv
㚢	nurn
伮	nury
恧	nve
聏	nvee
䖡	nvi
籹	nvmn
朒	nvo
朒	nvor
䘐	nvxd
衂	nvxr
䚼	nvyi
鮾	nwa
鯘	nwan
䲎	nwaw
㨅	nwfn
娞	nwn
脮	nwo
腇	nwon
㼏	nwpg
氝	nwpr
氝	nwqn
㐻	nwr
黁	nygo
㳶	nzdv
䰭	nze
搙	nzfc
䅶	nzhc
鐞	nzjc
啂	nzkv
槈	nzmc
檽	nzme
獳	nzqe
㝹	nzud
㜌	nzuy
䨲	nzy
羺	nzye
㵊	nady
吶	nakr
䪏	naln
挐	nanu
袦	napi
貀	navi
䈫	navn
笝	navy
誽	naye
䛔	naye
䚾	nbyr
獶	ncqw
碯	ncux
悩	ncxk
䜀	ncyv
疓	ndbn
㮏	ndmx
褦	ndpb
䘅	ndsi
䍲	ndye
廼	ndzx
㜛	nfnr
㲌	ngmn
䏻	ngss
灢	nhdy
㶞	nhdy
屰	nibp
觬	nide
聻	nide
㠜	nier
抳	nifb
㩘	nifw
馜	nihb
䵒	niho
輗	niie
䦵	nimx
婗	nine
嫟	nink
嬺	ninx
眤	niob
胒	niob
晲	nioe
䘦	nipb
屔	niqb
儞	nirx
貎	nive
齯	nive
㦐	nixb
㥾	nixk
䛏	niyb
誽	niye
迡	nizb
孴	nizo
㓓	njdg
揇	njfg
枏	njma
枬	njmd
䊖	njmg
侽	njrl
畘	njtr
䈒	njvg
䛁	njya
㲰	nkbm
㣷	nkid
㲽	nmdr
涊	nmdx
秥	nmhk
䄹	nmhq
焾	nmhx
簐	nmvr
䟢	nmzx
䮍	nnmy
䙚	nnny
㜵	nnny
㘃	nokx
糑	nomd
糥	nome
㛂	nonb
蹃	nozk
苶	npcx
湼	npdg
揑	npfg
㸎	nphe
鑈	npjx
櫱	npkm
糱	npkm
㘝	npky
㮆	npmy
㙞	nptm
䇣	npvx
臲	npzv
沑	nqdi
汼	nqdn
燶	nshn
䵜	nshn
檂	nsmn
禯	nspn
譨	nsyn
䅶	nuhc
沑	nvdi
㵖	nvdx
䶊	nvzi
錗	nwjn
鎒	nzjc
䘫	nzny
譳	nzye
𨺙	nie_
𦰡	noc_
℃	od
□	of
（	oh
）	oj
㎡	op
↓	ox
＆	oan
＆	oand
＠	oat
≠	obd
≯	obdy
∮	obh
∶	obi
∪	obj
∷	obl
≮	obx
≮	obxy
艹	occ
×	oco
♀	ocx
℡	odh
°	odu
√	odv
＝	ody
≥	odyd
夞	oes
■	ofk
卐	ofw
嗯	ogk
≡	ohd
㎎	ohk
㎜	ohm
◎	ohx
×	oig
÷	oiu
⊥	oiv
∠	ojd
∫	ojf
·	ojg
∩	ojj
＃	ojk
－	ojm
↑	oju
＋	ojx
→	ojy
↗	ojyu
↘	ojyx
←	ojz
↖	ojzu
↙	ojzx
Ⅷ	olb
Ⅳ	old
Ⅱ	ole
Ⅸ	olj
●	olk
Ⅵ	oll
㎝	olm
Ⅶ	olq
Ⅲ	ols
Ⅹ	olu
Ⅴ	olw
◇	olx
◆	olxh
Ⅰ	oly
$	omy
嗯	onk
№	ono
Ω	oom
桛	oomx
筽	oov
€	ooy
π	opd
∥	opx
≌	oqd
∑	oqh
㎏	oqk
㎞	oqm
¥	orm
¥	ormb
…	osd
△	osj
▲	osjh
∴	oss
∵	osy
™	otm
®	oub
®	oubr
藲	ouck
蕅	oucy
熰	ouh
Ⅻ	ouie
Ⅺ	ouiy
鏂	ouj
䥲	oujr
櫙	oum
䳼	oun
腢	ouo
膒	ouok
䙔	oup
㒖	oury
䌔	ous
䌂	oust
塸	out
齵	ouv
䉩	ouvk
↕	ouxj
㼴	ouyw
∝	ovb
±	ovf
㈱	ovu
※	ovui
卍	owj
∞	owq
∞	owqd
☆	owx
★	owxh
＿	oxh
＿	oxhx
∽	oxs
♂	oxx
≤	oxy
≤	oxyd
≈	oydy
↔	ozy
↔	ozyj
鴎	oukn
吘	oukw
䉱	ouvk
䯲	paa
皅	pab
苩	pacb
妑	pan
袙	papb
怕	pax
朩	pban
䎙	pbbx
薲	pbcb
汖	pbeu
馪	pbhb
蠙	pbib
嚬	pbkb
矉	pbo
㺍	pbqb
琕	pbwu
炰	pcbh
藨	pcc
萢	pccs
匏	pcdb
䩝	pcgg
瓟	pcgs
穮	pchh
蚫	pcis
㘐	pckx
㚿	pcn
褜	pcoy
礟	pcux
爮	pcvs
䶌	pczs
䱝	pda
䖰	pdin
棑	pdm
㭛	pdmn
犤	pdnb
猅	pdqf
簰	pdv
㾦	pfbk
瓫	pfbw
翉	pfbx
葐	pfc
濆	pfdb
呠	pfkb
喯	pfkc
㖹	pfkm
翸	pfux
鬔	pgaf
鬅	pgao
䰃	pgay
皏	pgbk
匉	pgbp
㤣	pgbx
苹	pgcp
漨	pgdf
淎	pgdl
泙	pgdp
剻	pge
挷	pgfe
㧸	pgfl
掽	pgfy
弸	pgg
熢	pghf
稝	pgho
䡫	pgif
輣	pgio
軯	pgip
䥋	pgjh
錋	pgjo
鑝	pgjz
韸	pglf
䦕	pgmk
梈	pgml
駍	pgmp
槰	pgmz
㛁	pgn
䄘	pgpf
㼞	pgpw
傰	pgro
纄	pgsz
塳	pgtf
塜	pgtu
蟚	pgui
硑	pguk
竼	pgvf
恲	pgxk
㥊	pgxo
憉	pgxp
䍬	pgyp
踫	pgzy
鰟	phaf
巼	phas
㝑	phbf
汸	phdf
㫄	phef
髈	phgf
炐	phhf
龎	phia
厐	phil
嗙	phk
嗙	phkf
嫎	phn
胮	phol
喸	phos
沗	phtu
尨	phud
篣	phvf
舽	phvl
䒍	phwb
覫	phwe
霶	phyf
䠙	phzf
魮	piab
魾	piap
疈	piat
鮍	piay
㿙	pibd
鵧	pibn
㳪	pidk
濞	pidl
潎	pidw
阰	pieb
岯	piep
擗	pif
㨢	pifb
㨽	pifd
抷	pifp
揊	pift
旇	pify
庀	pigb
螷	pigi
炋	pihb
秠	pihp
秛	pihy
蚽	piip
䡟	piiu
䤨	pijn
釽	pijv
嚊	pikl
鴄	pikn
耚	pily
榌	piml
駓	pimp
䴽	pimu
嫓	pinb
肶	piob
䏘	pioe
脴	piok
腗	piol
䫌	pipb
䲹	pipn
鼙	piu
噽	piup
憵	piux
㓟	pivd
豾	pivp
疋	pivr
㺽	piwp
怶	pixy
䚰	piyb
䠘	pizb
䰔	pjam
䰉	pjay
頖	pjbb
鵥	pjbn
䆺	pjbt
蒰	pjcy
洀	pjdv
湴	pjdy
拌	pjf
拚	pjfc
鋬	pjfj
㢖	pjgt
炍	pjhy
柈	pjmb
畨	pjmt
䙪	pjmy
眅	pjoy
坢	pjtb
媻	pjvn
縏	pjvx
詊	pjyb
跘	pjzb
鲆	pka
鮃	pkap
艵	pkbb
郱	pkbe
淜	pkdo
㵗	pkdu
慿	pkdx
岼	pke
聠	pkek
缾	pkfk
䍈	pkfp
庰	pkgb
焩	pkho
蚲	pki
輧	pkig
蛢	pkik
帲	pkjg
竮	pklk
娦	pknb
䀻	pko
胓	pkop
㺸	pkry
砯	pkud
箳	pkvk
㻂	pkwk
甹	pkyv
魸	pmap
骿	pmgk
翩	pmh
㓲	pmhd
㼐	pmhg
鶣	pmhn
囨	pmkb
㸤	pmlu
楄	pmmc
腁	pmog
賆	pmok
䏒	pmop
覑	pmpe
獱	pmqb
缏	pms
貵	pmsb
皫	pnbh
䕯	pncg
䏇	pnex
旚	pnfx
魒	pngx
徱	pnix
骠	pnm
闝	pnmw
犥	pnnh
㬓	pnox
㹾	pnqk
僄	pnrx
磦	pnu
篻	pnvx
顠	pnxb
彯	pnxp
㼼	pnxw
醥	pnyx
髲	poay
敀	pobw
䎅	pobx
蔢	poc
蒪	pocc
岶	poeb
岥	poey
㧊	pofl
㩯	pofx
䯙	pogf
烞	pohb
尀	pokc
嘙	pokn
㗶	poky
䪙	polc
䪖	polw
駊	pomy
㛘	pon
娝	ponk
謈	poo
昢	pooi
䞟	potb
砶	poub
酦	poy
醗	poya
䣮	poyd
䨰	poyg
䍨	poyl
醱	poyy
廹	pozb
覕	ppbe
鐅	ppdj
嫳	ppdn
暼	ppdo
撆	ppdu
潎	ppdw
䥕	ppjw
鯆	puaf
䲕	puao
痡	pubf
葡	puc
蒱	pucb
蒲	pucp
溥	pud
陠	puef
抪	pufj
擈	pufw
巭	pugf
烳	puhf
炇	puhw
圑	pukc
攴	puly
㯷	pumf
檏	pumw
㹒	punf
㬥	puom
獛	puqf
㒒	purw
纀	pusf
圤	putb
䈻	puvf
㺪	puwb
㲫	puym
䴆	puyn
諩	puyy
䫊	pwbb
㾦	pwbk
蓜	pwcj
浿	pwdb
淠	pwdl
阫	pweb
陫	pwef
嶏	pwej
㟝	pwek
斾	pwfj
䊃	pwmj
馷	pwml
柸	pwmp
姵	pwnj
㚰	pwnp
肧	pwob
俖	pwrk
伂	pwrl
笩	pwvy
裵	pwwy
㤄	pwxl
怌	pwxp
䯽	pza
㕻	pzd
捊	pzfz
䬌	pzh
哣	pzk
咅	pzlk
䳝	pzln
㰴	pzlr
棓	pzm
娝	pzn
犃	pznk
垺	pzt
堷	pzto
颒	pzur
箁	pzv
䔤	pacb
帊	pajb
掱	pauu
穦	pbhb
㡦	pbjb
驞	pbmb
㰋	pbmb
礗	pbub
奅	pcde
鞄	pcgs
軳	pcis
䫽	pcjm
麭	pcms
㯡	pcms
㲏	pcpm
垉	pcts
㵺	pddu
輫	pdif
鎃	pdjn
簲	pdvu
箄	pdvu
歕	pfur
髼	pgaf
㠮	pgbg
莑	pgcf
漰	pgdo
㱶	pgdp
韼	pglf
椖	pgmf
騯	pgmf
樥	pgmf
閛	pgmp
胓	pgop
倗	pgro
磞	pguo
闏	phde
䅭	phhf
肨	phof
膖	phof
䏺	phof
䏾	phol
㥬	phxf
䨦	phyf
䯱	piab
髬	piap
毞	pibm
錃	pidj
渒	pidu
㱟	pidy
隦	pieu
崥	pieu
蠯	pigi
䰦	pigu
焷	pihu
鈚	pijb
鉟	pijp
錍	piju
銔	piju
銢	piju
㮰	pimb
㯅	pimu
膍	piob
䑄	piol
䑀	piou
䫠	pipb
禆	pipu
㼰	pipw
狓	piqy
伓	pirb
朇	piru
毘	pitb
壀	pitu
磇	piub
礕	piuk
鷿	piun
鸊	piun
礔	piuu
㵨	piuu
豼	pivb
笓	pivb
篺	pivu
悂	pixt
翍	pixy
䚹	piyb
諀	piyu
䤏	piyu
冸	pjdb
溿	pjdb
瀊	pjdm
沜	pjdp
鑻	pjju
牉	pjpb
㽃	pjpw
㐴	pjrx
䃲	pjum
鞶	pjvg
幋	pjvj
鎜	pjvj
盤	pjvm
搫	pjvu
頩	pkbb
甁	pkbw
蓱	pkck
䓑	pkck
軿	pkik
帡	pkjb
幈	pkjk
䶄	pkjp
檘	pkmu
塀	pktk
屛	pkug
簈	pkvg
䈂	pkvk
䛣	pkyv
㾫	pmbc
鍂	pmjj
䮁	pmmc
騈	pmmg
媥	pmnc
諚	pmyr
㵱	pndc
䴩	pngx
勡	pnxl
慓	pnxx
翲	pnxx
溌	poda
洦	podb
湐	podb
㨇	podu
䄸	pohb
鏺	pojy
櫇	pomb
䣪	poyl
哛	ppun
䔕	pucf
䧤	puef
巬	pugf
䗱	puif
䑑	puif
暜	pulo
䮒	pumf
柨	pumj
瞨	puof
贌	puof
舗	purf
䈬	puvf
菐	puyf
㳈	pwde
䣙	pwee
㧩	pwfj
毰	pwmk
㯁	pwmk
㧵	pzfk
抙	pzfu
婄	pznk
𨙶	pwa_
䰼	qba
鮼	qbay
寴	qbbe
㾣	qbbj
寑	qbby
菳	qbcj
菣	qbcy
澿	qbdx
㞬	qbeg
耹	qbev
㢙	qbgl
庈	qbgv
螼	qbia
㕋	qbij
蚙	qbiv
唚	qbky
䦦	qbmj
嫀	qbnh
斳	qbnj
媇	qbnm
懃	qbnx
昑	qbo
衾	qbr
鳹	qbrn
㮗	qbsm
矝	qbss
綅	qbsy
赾	qbtj
㘦	qbtl
埁	qbtv
䃢	qbur
䈜	qbvy
琹	qbwm
珡	qbwr
吢	qbxk
誛	qbyy
丌	qial
䰴	qiaq
䱈	qiax
盀	qibm
萕	qica
芞	qicq
䒻	qics
䔾	qicv
藄	qicx
奇	qid
䧵	qidf
觭	qidk
汔	qidv
濝	qidx
攲	qidy
䏅	qiex
䚍	qife
扱	qifj
栔	qifm
捿	qifn
缼	qifr
揭	qifv
摖	qifx
麡	qiga
綮	qih
罊	qiif
蚚	qiij
蛣	qiik
螧	qiio
䢀	qiiq
䗩	qiix
蚑	qiiy
邔	qije
呮	qikb
桤	qim
䣛	qime
䭶	qiml
骐	qimq
㰗	qimr
娸	qinb
䀙	qiod
㬤	qioh
肵	qioj
䏠	qiol
暣	qiom
盵	qioq
禥	qipt
剘	qiqd
鶈	qiqh
玂	qiqj
㐞	qiqv
倛	qirb
僛	qirr
伎	qiry
纃	qisa
綨	qisb
綥	qisl
緀	qisn
圻	qit
䟄	qitb
簱	qivb
琪	qiw
斉	qiwa
斊	qiwe
䶒	qiwn
欫	qiwr
璂	qiwt
懠	qixa
愒	qixv
霋	qiyn
踑	qizb
䟚	qizl
甈	qizw
䲔	qkaa
宆	qkbg
䔛	qkcb
葝	qkcl
濪	qkdb
凊	qkdo
靘	qkfb
郬	qkfe
掅	qkfo
廎	qkgb
檾	qkhm
鑋	qkij
軽	qkit
樈	qkme
甠	qkou
謦	qku
殸	qkuy
剠	qkwd
䯧	qkwk
䨝	qkyo
蘠	qlck
㳾	qldq
嶈	qle
唴	qlkq
嗴	qlks
䵁	qlmc
椌	qlmg
斨	qlpj
牄	qlpk
墏	qlpt
羗	qlqs
篬	qlvk
瑲	qlwk
蹡	qlzc
鬝	qma
鬜	qmao
鰬	qmaw
褰	qmb
茾	qmck
欠	qmd
灊	qmdl
汘	qmdq
壍	qmdt
㦮	qmeg
嵰	qmen
岒	qmev
㩃	qmfd
攑	qmfl
㩷	qmfm
撁	qmfn
攓	qmfr
摼	qmft
拪	qmfx
揵	qmfy
䪈	qmgk
顅	qmhb
黚	qmhg
㦿	qmhm
䵛	qmht
蚈	qmik
婜	qmin
輤	qmio
軡	qmiv
臤	qmiy
鐱	qmjr
鈆	qmjs
嗛	qmkn
㗔	qmkw
騚	qmmd
槏	qmmn
䊴	qmmr
櫏	qmmv
榩	qmmw
橬	qmmy
媊	qmnd
孅	qmnj
膁	qmon
䀒	qmoq
䁮	qmoy
刋	qmqd
偂	qmrd
諐	qmrk
傔	qmrn
欦	qmrr
仱	qmrv
纤	qms
䭤	qmuk
兛	qmuq
䈴	qmvn
悓	qmxe
忴	qmxv
遣	qmz
䱁	qnab
藮	qnch
菬	qnck
荍	qncw
嵪	qnek
陗	qneo
撽	qnfw
鞩	qngd
㢗	qngk
㚽	qngn
燋	qnh
䵲	qnhm
鐈	qnjk
帩	qnjo
嘺	qnkk
鄥	qnne
嫶	qnnh
犞	qnnk
郻	qnoe
睄	qnoo
鄡	qnpe
顦	qnrb
僺	qnrm
繑	qnsk
趫	qntk
墽	qntw
碻	qnuk
䂭	qnux
䯨	qnwd
愀	qnxq
䫞	qnyb
䀉	qnym
䎗	qnyx
蹻	qnzk
躈	qnzw
踍	qnzz
㾜	qpbr
㾀	qpbs
藒	qpcv
㚗	qpdq
㤲	qpdx
蛪	qpfi
穕	qphm
厒	qpif
匧	qpk
㗫	qpkx
䦧	qpme
㛗	qpn
㛍	qpnr
猰	qpqd
㹤	qpqs
倿	qprn
緁	qps
朅	qptv
笡	qpvq
籡	qpvr
悏	qpxr
踥	qpz
鰽	qqao
䲡	qqaq
鮂	qqar
䲡	qqay
蠤	qqbi
㐀	qqca
艽	qqcj
蓲	qqck
莍	qqcq
蘒	qqcv
殏	qqdq
汓	qqdz
䎿	qqeh
㟈	qqeq
崷	qqey
㧨	qqfk
搝	qqfq
龝	qqha
䨂	qqhf
蝵	qqhi
蝤	qqi
虯	qqil
釻	qqjw
㕤	qqkj
丠	qqla
朹	qqmj
梂	qqmq
㛏	qqnq
䐐	qqo
肍	qqoj
䊵	qqsj
絿	qqsq
坵	qqtq
玌	qqwv
㤹	qqxq
䟵	qqzq
齤	qrbr
觠	qrby
虇	qrcf
葲	qrcu
汱	qrdq
湶	qrdu
洤	qrdw
峑	qre
巏	qref
㟫	qreu
啳	qrkv
椦	qrml
孉	qrnf
犈	qrnv
䑏	qrof
腃	qrov
䀬	qrow
勧	qrpl
㒰	qrrg
䌯	qrsf
絟	qrsw
縓	qrsx
䟒	qrtf
硂	qruw
惓	qrxv
诠	qryq
䠰	qrzf
踡	qrzv
跧	qrzw
竆	qsbk
䆳	qsbu
藭	qscg
蛬	qsci
藑	qscw
卭	qsge
䅃	qsgh
䊄	qsgm
跫	qsgr
㧭	qsgu
熍	qshk
憌	qsjx
桏	qsme
橩	qsmj
㮪	qsmm
嬛	qsn
㑋	qsr
儝	qsrm
瞏	qssy
赹	qst
䠻	qsug
舼	qsvb
笻	qsve
璚	qswk
㼇	qswv
惸	qsxz
䛪	qsyg
㾡	qtbe
䧿	qtcf
蒛	qtcg
崅	qte
燩	qthw
礐	qtju
䇎	qtlo
㹱	qtqr
趞	qtto
硞	qtuk
䲵	qtun
㱿	qtuy
琷	qtwq
毃	qtwy
㕁	qtxe
麴	qua
鰸	quak
髷	quaq
魼	quas
鱋	quay
㸖	qubq
葋	quck
䒼	qucq
浀	qudq
㠊	quea
䧢	quek
岴	queq
阹	ques
抾	qufs
㧁	quhs
衢	qui
忂	quif
軥	quik
蟝	quim
鑺	qujf
匷	qukf
㖆	qukq
呿	quks
閴	qumb
欋	qumf
臞	quof
戵	quog
鸜	quon
䁦	quoq
朑	quou
刞	quqd
伹	qurq
佉	qurs
絇	qusk
㰦	qutr
䝣	quvm
筁	quvq
躣	quzf
䢗	quzq
迲	quzs
冾	qxdk
圶	qxdt
峠	qxe
㓞	qxfd
揢	qxfk
䯊	qxgk
鞐	qxgx
㡊	qxjj
帢	qxjk
匼	qxk
䁍	qxo
㓣	qxrd
㓤	qxud
磍	qxuk
䶝	qxvr
愘	qxxk
酠	qxyk
跒	qxzk
峮	qyek
麕	qygh
䭽	qym
歏	qynr
夋	qysw
箘	qyvh
裠	qyyy
䜷	qbay
瘽	qbba
㝲	qbbj
㾛	qbby
藽	qbce
菦	qbcj
䔷	qbcv
瀙	qbde
㓎	qbdy
捦	qbfj
抋	qbfx
㩒	qbfx
靲	qbgv
蠄	qbid
顉	qbjb
鈙	qbjy
梫	qbmy
雂	qbrf
㪁	qbry
坅	qbtv
笉	qbvd
懄	qbxl
㤈	qbxx
鬐	qiao
䰇	qiao
䏌	qibo
疧	qibu
䭬	qibz
䭫	qibz
䔇	qica
䓅	qicj
䒗	qicq
渏	qidk
㱦	qidk
鵸	qidn
湆	qido
湇	qido
㩻	qidy
岓	qiej
㟓	qiej
嵜	qiek
﨑	qiek
㟢	qiek
㠌	qier
掑	qifb
䫔	qifb
䚉	qife
魌	qigb
鬿	qigj
䩓	qigs
䅤	qihj
䄫	qihj
諬	qihk
啔	qihk
晵	qiho
䁈	qiho
䁉	qiho
䏿	qiho
䅲	qiho
䋯	qihx
㣬	qiie
蟿	qiii
蚔	qiiu
軝	qiiu
䡔	qiix
䡋	qiiy
帺	qijb
釮	qijc
䥓	qijt
唭	qikb
㖢	qikb
咠	qike
噐	qikk
䎢	qilq
騹	qima
粸	qimb
檱	qimb
㟚	qime
䭼	qiml
㯦	qimm
桼	qimu
䉻	qimu
闙	qimw
櫀	qimx
鶀	qinb
䲬	qinu
㫓	qioq
䄢	qipa
褀	qipb
䙄	qipj
䄎	qipk
褄	qipn
猉	qiqb
䫏	qiqb
蜝	qiqi
碁	qiqk
棊	qiqm
䳢	qiqn
憇	qiqx
気	qiqx
㒅	qiry
緕	qisa
紪	qisb
䌌	qisb
䞚	qity
矵	qiud
礘	qiuh
㞚	qiuj
碕	qiuk
唘	qiuk
㞓	qiuo
磩	qiux
㩽	qiuy
艩	qiva
籏	qivb
簯	qivb
䑴	qivb
䶞	qivb
竒	qiwk
䐡	qiwr
夡	qixk
㥓	qixk
忔	qixq
忯	qixu
慽	qixx
諆	qiyb
諿	qiye
迉	qizu
寈	qkbo
淸	qkda
殑	qkde
㵾	qkde
靑	qkfa
㩩	qkfb
擏	qkfw
䋜	qkhx
䡖	qkit
䞍	qkko
䝼	qkko
棾	qkmj
櫦	qkmw
㯳	qkmw
暒	qkou
儬	qkre
埥	qkto
㷫	qkuh
硘	qkuk
漀	qkuu
夝	qkxu
㾤	qlbg
漒	qldi
溬	qlds
㩖	qlfa
摤	qlfx
廧	qlgk
鎗	qljk
㛨	qlnq
猐	qlqq
獇	qlqs
謒	qlyk
䤌	qlyk
羻	qlyw
皘	qmbo
䞿	qmbr
㪠	qmby
䕭	qmch
蔳	qmco
嬱	qmdn
濳	qmdy
拑	qmfg
㧄	qmfk
㩮	qmfu
扲	qmfv
㨜	qmfw
攐	qmfy
䖍	qmhw
㟻	qmie
蜸	qmii
㜞	qmin
㹂	qmin
掔	qmiu
䵖	qmiu
孯	qmiz
鎆	qmjd
銭	qmjg
鑓	qmjk
鏲	qmjn
雃	qmkf
䇂	qmll
竏	qmlq
檶	qmmk
㯠	qmmn
棈	qmmo
粁	qmmq
騝	qmmy
㸫	qmnj
奷	qmnq
谸	qmqk
圱	qmqt
俔	qmre
儙	qmrk
㐸	qmrr
綪	qmso
䥅	qmuj
乹	qmuv
箝	qmvg
䈤	qmvg
籖	qmvj
篟	qmvo
䑶	qmvo
篏	qmvr
䇜	qmvr
歬	qmvv
箞	qmvv
䉦	qmvv
瓩	qmwq
羬	qmyk
癄	qnbh
㝯	qnbk
䆻	qnbw
㴥	qndo
鞽	qngk
䲾	qngn
骹	qngx
㤍	qngx
㡑	qnhj
燆	qnhk
幧	qnjm
鐰	qnjm
釥	qnjx
韒	qnlo
䇌	qnlo
䩌	qnmh
槗	qnmk
趬	qntw
㚁	qntw
䂪	qnud
䃝	qnuw
頝	qnwb
髚	qnwj
髜	qnwu
鯜	qpan
苆	qpcd
淁	qpdn
聺	qpex
㓶	qpfd
洯	qpfu
㼤	qpfw
鐑	qpjk
䤿	qpju
㥦	qpkx
䟙	qpzd
蟗	qqai
鯄	qqaq
㷕	qqbh
䜪	qqbj
蘒	qqcd
觓	qqdl
浗	qqdq
觩	qqdq
㳋	qqdq
湭	qqdy
渞	qqdz
扏	qqfj
穐	qqhd
秌	qqhh
媝	qqhn
煪	qqhy
醔	qqhy
蛷	qqiq
釚	qqjj
叴	qqjk
䤛	qqjl
鵭	qqjn
銶	qqjq
唒	qqky
㭝	qqmj
㚱	qqnq
䣇	qqqe
盚	qqqm
皳	qqqy
紌	qqsy
緧	qqsy
趥	qqty
篍	qqvh
㺫	qqwd
恘	qqxm
㥢	qqxy
訅	qqyj
䟬	qqzq
䠗	qqzq
逎	qqzy
䠓	qqzy
韏	qrbl
牶	qrbn
搼	qrfu
䅚	qrhv
烇	qrhw
蠸	qrif
䄐	qris
鐉	qrjb
圏	qrkj
権	qrmf
楾	qrmu
騡	qrmu
闎	qrmu
䊎	qrmv
駩	qrmw
牷	qrnw
姾	qrnw
㒽	qrov
埢	qrtv
恮	qrxw
焪	qshg
焭	qshj
㷀	qshu
㒌	qsrj
睘	qssy
瓗	qswk
皵	qtcy
㴶	qtdf
搉	qtff
㩁	qtff
䦬	qtmd
㰌	qtmf
塙	qttk
墧	qttk
礭	qtuf
㲉	qtuy
㱋	qtyr
䍳	qtyy
䵶	quba
斪	qubj
䆽	qubu
菃	qucj
䓚	qucq
䒧	qucs
淭	qudm
厺	quds
㣄	qugm
蠷	quif
衐	quii
䖦	quii
蝺	quiy
螶	quji
㘗	qukf
匤	quky
耝	qulq
竬	quly
駈	qumq
麮	qums
㯫	qumu
駆	qumx
㜹	qunf
䂂	quof
胊	quok
㲘	quom
㫢	quos
㻃	quqy
䋧	qusk
紶	quss
鼁	quta
䞤	qutk
䟊	qutu
䶚	quvi
䈌	quvq
籧	quvu
璖	quwm
翑	quxk
翵	quxn
憈	quxy
誳	quyi
詓	quys
䠐	quzq
殎	qxdr
硈	qxuk
䂒	qxuk
㤉	qxxy
䨐	qxyk
宭	qybk
㿏	qyby
㟒	qyek
帬	qyyj
羣	qyyy
㪊	qyyy
𨟠	qro_
𨟠	qto_
囕	ramo
罖	ras
隢	rce
犪	rcnw
襓	rcp
㑱	rcrm
遶	rczw
魜	rfa
芢	rfce
菍	rfcx
刄	rfdn
忈	rfex
扨	rffr
靱	rfgn
朲	rfmr
棯	rfmx
姙	rfnr
㸾	rfnx
肕	rfo
䏕	rfor
腍	rfox
忎	rfqx
栠	rfrm
仭	rfrn
䋕	rfrx
䌾	rfsg
綛	rfsx
䇮	rfvr
讱	rfy
芿	rgc
芿	rgcn
陾	rge
陾	rged
䄧	rghn
㭁	rgmn
礽	rgp
礽	rgpn
㺱	rgry
䚮	rgyn
辸	rgzn
鬤	rha
爙	rhhy
䑋	rho
獽	rhqy
䉴	rhvy
勷	rhwl
䒤	rico
鈤	rijo
釰	rijr
囸	rik
驲	rim
馹	rimo
氜	riqo
髥	rjaa
㾆	rjbr
䒣	rjca
䕼	rjcf
䔳	rjch
蒅	rjcm
熯	rjhf
蚦	rjia
㲯	rjim
䤡	rjj
冄	rjka
嘫	rjkh
呥	rjkr
橪	rjmh
㚩	rjna
㜣	rjnh
媣	rjnm
姌	rjnr
肰	rjo
衻	rjpa
䫇	rjpb
袇	rjpd
䳿	rjpn
袡	rjpr
㒄	rjrh
䣸	rjry
繎	rjsh
㿵	rjvd
珃	rjw
珃	rjwr
鰯	roa
鰙	roak
渃	rodk
嵶	roe
捼	rofn
鶸	rogn
焫	roh
楉	rom
䐞	roo
㬉	rord
篛	rovd
耎	rred
䎡	rreh
蝡	rrid
䪭	rrlo
㮕	rrmd
嫰	rrnr
朊	rro
腝	rrod
偄	rrr
緛	rrs
壖	rrte
碝	rrud
礝	rrue
瑌	rrwd
愞	rrxd
髶	rsae
䢇	rsbc
䇀	rsbe
宂	rsbj
㲨	rscm
茙	rscu
瀜	rsdi
峵	rses
搈	rsf
搑	rsfe
摉	rsfx
䩸	rsge
㣑	rsgp
穃	rshk
爃	rshm
烿	rshp
軵	rsic
䡥	rsik
螎	rsil
㘇	rsk
榵	rsme
㲝	rsmf
駥	rsmu
嫆	rsn
媶	rsne
嬫	rsnm
肜	rso
曧	rsoi
肜	rsop
褣	rsp
䘬	rspu
㺎	rsql
傇	rsre
縙	rsse
氄	rssm
䈶	rsv
䇯	rsve
䠜	rsz
鱬	rua
薷	ruc
蒘	rucu
蕠	rucx
渪	rudy
嶿	rue
㨎	rufd
擩	rufe
扖	rufr
嗕	rukc
杁	rumr
桇	runm
鴽	runn
䋈	runx
曘	ruo
肗	ruon
袽	rupk
侞	rurk
鳰	rurn
㐈	rurv
㐵	rury
繻	ruse
䋴	rusm
䞕	rute
筎	ruvk
颥	ruy
䰰	ruyg
込	ruzr
䓲	rvce
蘂	rvcm
蕋	rvcv
㢻	rvgn
䅑	rvhn
鋭	rvje
壡	rvlt
叡	rvly
桵	rvmn
䌼	rvse
緌	rvsn
䂱	rvue
䇤	rvv
甤	rvvu
橤	rvxm
㠈	ryew
橍	rymw
閠	rymy
䏰	ryo
鰇	rzam
宍	rzbb
葇	rzc
煣	rzhm
蝚	rzim
鍒	rzjm
厹	rzjs
禸	rzks
韖	rzlm
媃	rznm
腬	rzo
䐓	rzob
䋴	rzsm
鶔	rzsn
㽥	rztm
瑈	rzw
䧷	rzwf
㹛	rcnw
荵	rfcx
屻	rfer
岃	rfer
秹	rfhr
秂	rfhr
鈓	rfjr
銋	rfjr
㠴	rfjr
杒	rfmr
栣	rfmr
梕	rfmx
牣	rfnr
䀔	rfor
袵	rfpr
㶵	rfrh
鵀	rfrn
餁	rfur
躵	rfux
䭃	rfux
㣼	rfxr
䛘	rfyr
穣	rhhy
纕	rhsy
壌	rhty
懹	rhxy
譲	rhyy
躟	rhzy
䖄	rjch
㸐	rjnh
挼	rofn
䓴	rrcd
㓴	rred
撋	rrfw
㼱	rrlw
䞂	rrod
䙇	rrpd
㽭	rrte
㝐	rsbs
㼸	rsbw
穁	rshe
嵤	rshe
䡆	rsis
㭜	rsmu
㲓	rsmu
䋴	rssm
坈	rstj
栄	rsxm
䤊	rsye
㾒	rubk
燸	ruhe
䄾	ruhu
鄏	ruie
㦺	ruig
媷	runc
邚	rune
㹘	rune
帤	runj
鴑	runn
㐠	rupv
醹	ruye
蘃	rvcm
䄲	rvhn
㓹	rvid
蜹	rvin
䬐	rvjn
㲊	rvly
㪫	rvly
繠	rvxx
䦞	rymw
膶	ryow
䰆	rzam
渘	rzdm
輮	rzim
粈	rzmi
楺	rzmm
騥	rzmm
瓇	rzww
𩧬	rjmr
𥆧	ryow
丧	sh
虄	sacu
桬	sadm
泧	sadv
隡	sae
栍	saen
摋	saf
钑	sajj
䬃	sajl
鏾	sajw
櫒	samx
䊛	samy
㚫	san
䙣	sap
㒎	sarf
㽂	sarw
㪪	sat
鳋	sca
鰠	scai
鱢	scam
㿋	scbm
䕅	scc
煰	schk
颾	scj
氉	sckm
騒	scmi
㛮	scny
矂	scom
髞	scwm
慅	scx
䰄	sdax
䚡	sddx
㩙	sdft
揌	sdfx
㘔	sdkb
毢	sdmx
僿	sdrt
顋	sdtb
䈢	sdvm
簺	sdvt
愢	sdxx
瘷	sebw
㥶	sebx
䔼	sec
濏	sedb
瀒	sedk
㴔	sedx
擌	sef
穯	sehk
轖	sei
飋	sejb
鏼	sejn
槭	sem
栜	semn
閪	semx
縇	seon
歰	serv
繬	sesk
㱇	setr
䉢	sev
歮	sevv
琗	sewu
懎	sexk
雭	seyj
譅	seyv
椮	sfmp
襂	sfp
篸	sfvp
鬙	sga
䡦	shi
鎟	shjm
槡	shm
褬	shpm
䫙	shub
䲉	siaj
䇁	siby
䔮	sicj
蕬	sicx
泗	sid
洍	sidl
瀃	sidw
亖	siee
厕	siid
鼶	sijj
鉰	sijk
釲	sijs
噝	sikx
䎣	silr
䇃	sils
榹	simj
梩	siml
㹑	sinb
牭	sine
㚶	sink
㸻	sinu
媤	sinx
䏤	sio
禗	sipx
㽄	siqw
㒋	sirj
儩	sirw
飤	siur
貄	sivy
㺨	siws
鬖	sja
䫅	sjbb
㪚	sjcw
潵	sjdw
鏾	sjjw
糂	sjmv
糣	sjmy
犙	sjnp
俕	sjrm
仐	sjru
䈀	sjvd
䉈	sjvw
弎	sjys
㪽	soaj
髿	soau
鮻	soaw
䓾	socn
溑	sodb
摍	sofb
螦	soix
鏁	sojg
䵀	somb
㮦	somx
㛖	son
䐝	soob
暛	soog
乺	sopv
傞	sor
趖	sott
䞽	sotx
䈗	sovw
簔	sovy
琑	sowo
䣔	soxe
逤	sozu
祘	srex
匴	srkc
笇	srvb
筭	srvc
䝜	srvw
䯷	ssa
䯳	ssas
枀	ssbm
䜬	ssby
凇	ssd
濍	ssdx
嵷	sser
颂	ssg
庺	ssgm
蜙	ssis
鎹	ssjt
枩	ssms
㮸	ssmt
檧	ssmx
耸	ssr
㞞	ssur
餸	ssut
䉥	ssvx
䛦	ssyk
䢠	sszc
䲆	suaa
鱐	sual
鯂	suay
愬	subx
蘓	suca
䔎	sucu
㴼	sudb
洬	sudd
潚	sudl
潥	sudm
㴑	sudp
溸	sudx
㨞	sufx
樎	sumb
櫯	sumh
樕	sumr
榡	sumx
㜚	sunb
膆	suo
㬘	suol
㑉	surd
㑛	suru
㕖	susm
縤	susx
趚	sutu
塐	sutx
䃤	suul
鷫	suvn
䎘	suvx
㲞	suwm
䅇	suxh
遡	suzo
遬	suzr
䔹	svcu
荾	svcw
芕	svcx
澻	svdu
滖	svdy
㞸	sveb
亗	svee
鐆	svej
䧌	sven
旞	svf
䪎	svgk
鞖	svgn
髄	svgo
熣	svhf
䅗	svhn
煫	svhu
鐩	svju
哸	svkn
韢	svlx
嬘	svnu
膸	svoo
脺	svou
禭	svpu
倠	svrf
繀	svsf
繐	svsx
缞	svsy
埣	svtu
䉌	svvu
歳	svvx
㻪	svwn
㻽	svwv
䜔	svyo
遀	svzo
聓	swge
蕵	sycl
潠	sydb
飱	sydl
㔼	syfu
䁚	syob
鶽	syrn
巺	sysb
簨	syvb
箰	syvz
㦏	syxb
䱸	sza
瘶	szb
叜	szby
蓃	szcy
㟬	szey
摗	szfr
捒	szfu
捜	szfy
嗽	szk
櫢	szmw
騪	szmy
㛐	szn
䐹	szol
鄋	szpe
傁	szr
䈹	szvb
䈭	szvg
䉤	szvw
䑹	szvy
醙	szyy
馺	samj
訯	sayj
掻	scfi
㲧	scmi
㥰	scxy
㗷	sdkr
毸	sdmx
濇	sedk
渋	sedn
㒊	serv
㻭	sewu
䨛	seyj
槮	sfmp
䒏	sgbb
桒	shum
蕼	sicy
㴲	sidj
泀	sidk
泤	sidr
肂	sidy
燍	sihj
蟖	siij
䡳	siij
鐁	sijj
㠼	sijj
鈻	sijk
鈶	sijk
鋖	sijn
銯	sijx
㕽	sikr
耛	silk
竢	silu
䦙	simc
柶	sime
蜤	simi
㭒	simk
騦	simx
娰	sinr
禩	sipb
䫢	sipb
禠	sipj
恖	sipx
蟴	siqi
㺇	siqq
佀	sirk
俬	sirs
価	sirx
罳	sisx
磃	siuj
覗	sive
㣈	sivj
孠	sivz
㧲	sjfm
鏒	sjjp
閐	sjmm
䊉	sjmm
毶	sjmp
橵	sjmw
糤	sjmw
㪔	sjmy
厁	sjre
䫩	sjsb
壭	sjue
㤾	sjxm
䯯	soau
莏	socu
䔋	socu
挱	sofu
䖛	sohx
䅴	sohx
蜶	soiu
鎻	sojb
鎍	sojx
䞆	soob
䂹	souh
惢	soxx
梥	ssbm
捒	ssfu
㩳	ssfy
㨦	ssfy
㣝	ssiu
柗	ssmk
駷	ssmu
傱	ssrr
倯	ssrs
硹	ssus
憽	ssxx
愯	ssxy
㝛	subk
藗	sucr
泝	sudi
㴋	suds
殐	sudu
㢝	sugh
稡	suhu
䥔	sujm
鋉	suju
㓘	sujy
橚	suml
梀	sumu
㯈	sumu
嫊	sunx
䌚	susm
碿	suuo
餗	suuu
䑿	suvb
粛	suvl
㪩	suvy
珟	suwd
璛	suwl
㔄	suxd
憟	suxm
䛾	suyx
㒸	svbu
浽	svdn
瀡	svdo
㵦	svdo
㴚	svdu
䯝	svgo
穂	svhx
䡵	sviu
䥙	svju
檖	svmu
睟	svou
賥	svou
繸	svsu
䍁	svsu
䭉	svuo
砕	svuu
瓍	svwo
㻟	svwo
㥞	svxu
譢	svyu
䢫	svzo
䠔	svzu
薞	sycl
搎	syfx
鎨	syju
槂	symx
䐣	syob
凁	szdu
䏂	szey
撨	szfh
廀	szgy
䩳	szgy
䗏	sziy
颾	szji
䬒	szjy
䤹	szjy
䮟	szmy
獀	szqy
籔	szvw
跳	tn
鮙	taax
澾	tady
崉	tae
㧺	tafo
搨	tafx
䵬	taho
㣛	taik
錔	tajo
咜	takb
㭼	tamo
橽	tamy
㛥	tano
牠	tany
毾	tao
禢	tapx
䑜	taqm
㹺	taqo
㺚	taqy
侤	tarv
㒓	tary
䳴	tasn
䌈	tasx
塔	tat
墖	tatt
䶀	tauk
濌	tavo
䑽	tavx
譶	tawk
䎓	taxo
誻	tayo
遢	tazy
夲	tcdu
焘	tcf
鞱	tcgj
䄻	tchd
䵚	tchj
㣠	tcid
蜪	tcif
轁	tcij
䬞	tcjc
鋾	tcjf
幍	tcjj
錭	tcjk
駣	tcmd
騊	tcmf
槄	tcmj
㹗	tcn
䀞	tco
祹	tcpf
㫦	tcro
䈱	tcvj
醄	tcyf
詜	tcyy
迯	tczb
菭	tdck
㷘	tdhm
㸀	tdht
㘆	tdkt
粏	tdmt
嬯	tdnt
旲	tdod
㬃	tdoh
㑷	tdrb
儓	tdrt
㣍	tdsp
坮	tdtk
㙵	tdtt
箈	tdvk
舦	tdvt
珆	tdwk
䣭	tdyq
㧹	tef
蟘	teib
犆	ten
犆	tenq
脦	teo
㥂	texc
貣	teyb
䕨	tgcx
驣	tgmm
幐	tgoj
儯	tgrm
鼟	tgua
䲍	tgva
䒅	tgvo
籐	tgvu
籘	tgvx
霯	tgya
邆	tgza
㿩	thbh
薚	thc
蓎	thck
溏	thdt
嵣	the
䧜	thek
隚	thet
摥	thfw
㲥	thgm
鞺	thgt
㼺	thgw
煻	thh
爣	thhh
蝪	thiw
铴	thj
钂	thjh
啺	thkw
榶	thmk
㜍	thnk
曭	thoh
膅	thok
傏	thrk
㒉	thrm
㑽	thrt
偒	thrw
䌅	thsk
䞶	thtw
磄	thuk
鼞	thut
篖	thvk
䉎	thvm
㙶	thwt
戃	thxh
醣	thyk
䟖	thze
䠀	thzk
踼	thzw
䱱	tiaj
鯷	tiar
髰	tiau
鬄	tiaw
鹈	tib
䶏	tibl
蕛	ticp
䔶	ticr
䚣	tidr
崹	tie
挮	tifp
䪆	tiga
稊	tihp
䖙	tiij
徲	tiin
㣢	tiip
蝭	tiir
鷤	tikn
㖒	tikp
楴	timj
騠	timr
媂	tinj
㬱	tiny
鶗	tion
䏲	tiop
惖	tiox
褅	tipj
䙗	tipk
禔	tipr
悐	tiqx
偍	tirr
䌡	tisa
趧	titr
軆	tiua
䬫	tiud
䬾	tiup
碮	tiur
瓋	tiwk
鶙	tiwn
珶	tiwp
鴺	tiyn
䛱	tiyx
䢰	tizf
䶑	tizr
逷	tizw
痰	tjb
藫	tjcu
潬	tjda
㳩	tjdd
㴂	tjdr
探	tjf
擹	tjfr
弾	tjga
顃	tjhb
㲭	tjhm
镡	tjj
嘽	tjka
嗿	tjkb
䦔	tjmd
婒	tjnh
暺	tjoa
㫜	tjod
䐺	tjou
䏙	tjov
䑙	tjqa
舕	tjqh
舑	tjqr
㽎	tjqv
僋	tjrb
傝	tjrx
繵	tjsd
埮	tjth
㘱	tjtr
貚	tjva
䉡	tjvd
憳	tjxc
䜖	tjyb
醓	tjym
䱓	tkar
㼗	tkdw
聤	tke
嵉	tked
聴	tkex
庁	tkgd
鞓	tkgw
廰	tkgx
鼮	tkjr
楟	tkmd
閮	tkmr
䦐	tkmu
榳	tkmz
脡	tko
䋼	tksm
綎	tksr
䵺	tktv
艈	tkvv
諪	tkyd
頲	tkzb
㐁	tma
窴	tmbb
畠	tmbt
菾	tmcx
䧃	tme
搷	tmfb
靝	tmfm
靔	tmfq
甛	tmgk
㬲	tmgm
䄼	tmhk
䡒	tmit
唺	tmkb
㖭	tmkx
㮇	tmmx
婖	tmn
娗	tmnr
胋	tmok
睼	tmor
䀖	tmot
䑚	tmqo
倎	tmrb
緂	tmsh
塡	tmtb
磌	tmub
餂	tmuk
鷏	tmun
屇	tmut
酟	tmyk
䠄	tmzb
䟧	tmzt
䱔	tnaw
宨	tnbd
窱	tnbm
芀	tncd
蓚	tncp
岹	tne
聎	tned
岧	tnek
庣	tngd
啁	tnkk
㕮	tnkx
㬸	tnob
晀	tnov
㸠	tnpd
祒	tnpk
鯈	tnra
鞗	tnrg
䖺	tnri
絩	tnsd
䠷	tnud
恌	tnxd
誂	tnyd
鮀	toab
鰖	toao
魠	toaq
䰿	toay
㾃	tobb
莌	toce
蘀	tocg
汑	todq
岮	toeb
㟎	toen
陁	toey
拕	tofb
捝	tofe
拓	tofk
撱	tofo
䡐	toib
彵	toiy
啴	tokl
䪑	tolb
驝	tomm
杔	tomq
駄	tomt
駞	tomy
媠	tono
㸱	tony
鵎	topn
乇	topq
侻	tore
紽	tos
碢	touk
槖	toum
饦	touq
砤	touy
詑	toyb
䜏	toyo
讬	toyq
迱	tozb
聑	tpe
鐡	tpja
䥫	tpjf
䴴	tpmk
驖	tpmw
僣	tpro
䵿	tpuk
鴩	tpun
飻	tpup
怗	tpxk
跕	tpzk
剸	tra
鷒	tran
䵎	trc
漙	trdc
湪	trdu
㩛	trfc
鏄	trjc
圕	trk
団	trkc
槫	trmc
鷻	trnw
褖	trpu
䝎	true
篿	trvc
貒	trve
慱	trxc
䜝	tryv
鮦	tsak
峒	tse
㠉	tsel
㣚	tsik
䳋	tsin
鉖	tsjd
囲	tskj
犝	tsnl
晍	tsok
獞	tsql
絧	tssk
㼧	tssw
㪌	tssy
憅	tsvx
筩	tsvy
㤏	tsxd
詷	tsyk
鷋	tucn
潳	tudo
涋	tudq
汢	tudt
嶀	tuek
㟮	tueq
捸	tufn
揬	tufq
䖘	tuhd
鵚	tuhn
馟	tuhz
鋀	tuja
鍎	tujo
図	tukx
梌	tum
㭸	tumd
檡	tumg
駼	tumh
鵌	tun
兎	tupd
峹	ture
䳜	turn
䞮	tuth
堗	tutq
鷵	tuun
㻌	tuwh
㻠	tuwq
悇	tuxh
䠈	tuzn
跿	tuzr
㿉	tvbb
㾼	tvbg
弚	tvbl
蘈	tvcb
蓷	tvcf
隤	tve
推	tvf
骽	tvgn
煺	tvh
頺	tvhb
㷟	tvhk
駾	tvme
娧	tvne
脮	tvon
僓	tvrb
俀	tvrn
䀃	tvum
㞜	tvun
㞂	tvyn
蹪	tvzb
蹆	tvzg
芚	tyct
涒	tydk
㧷	tyfk
㩔	tyfy
軘	tyit
㖔	tykk
啍	tykz
旽	tyot
朜	tyoz
褪	typ
㹠	tyqt
氽	tyr
㼊	tytg
畽	tytv
臋	tyur
呑	tyyk
霕	tyyt
䱏	tza
䕱	tzcb
斢	tzcu
黈	tzcv
鋀	tzja
鍮	tzjd
㖣	tzkk
敨	tzlw
㪗	tzly
妵	tznv
㓱	tzrd
緰	tzsd
䟝	tzzy
䓠	taco
涾	tado
㳠	tadz
䍇	taff
鞜	tago
㣵	taiy
㗳	takk
嚺	taku
嚃	taku
榙	tamk
㯚	tamk
㯓	tamx
闧	tamy
襨	tapc
狧	taqk
䍝	taso
䂿	tauo
䶁	tauo
䈋	tavo
䈳	tavx
㿹	tavy
䜚	tayu
蹹	tazx
躢	tazx
匋	tcbf
㚐	tcdd
搯	tcfj
䤾	tcjj
咷	tckd
飸	tckl
嫍	tcnj
裪	tcpf
饀	tcuj
䑬	tcvd
瑫	tcwj
䚯	tcyd
䛬	tcyf
謟	tcyj
䛌	tcys
䑓	tdct
汏	tddd
冭	tddd
夳	tdde
溙	tddu
炲	tdhk
燤	tdhy
囼	tdkk
枱	tdmk
㒗	tdrt
㑀	tdrt
籉	tdvt
䈚	tdvx
忲	tdxt
㥭	tdxu
孡	tdzk
朰	teul
痋	tgbi
駦	tgbm
虅	tgcm
漛	tgdu
膯	tgoa
鰧	tgoa
䠮	tgzm
䕋	thck
漟	thdt
鶶	thgn
㼒	thgw
䅯	thhk
鎕	thjk
㭻	thmk
橖	thmm
闛	thmt
糛	thmt
糃	thmw
矘	thoh
禟	thpk
伖	thry
赯	thtk
餹	thuk
饄	thut
㓥	thxd
坣	thxt
鬀	tiap
渧	tidj
殢	tidj
漽	tidn
洟	tidy
揥	tifj
掦	tifw
骵	tigb
䯜	tigw
戻	tihd
䅠	tihr
厗	tiiu
鍗	tijj
㡗	tijj
㗣	tikj
㔸	tikj
嚔	tikr
䎮	tilk
鷈	tinj
鷉	tipn
褆	tipr
罤	tisp
籊	tivf
笹	tivu
歒	tiwr
惿	tixr
謕	tiyj
㯩	tiyy
䨑	tiyy
蹏	tizj
䆱	tjbh
痑	tjbx
䕊	tjcd
㵅	tjdb
湠	tjdh
㨏	tjfh
㽑	tjgu
㷋	tjhh
㲜	tjhm
燂	tjhu
䗊	tjih
橝	tjmu
䊤	tjmu
㛶	tjnh
襢	tjpd
怹	tjrx
䞡	tjtd
墵	tjts
䃪	tjud
憻	tjxd
憛	tjxu
譠	tjyd
醈	tjyh
醰	tjyu
艼	tkcd
㓅	tkdd
邒	tkde
涏	tkdr
濎	tkdv
䯕	tkgr
䅍	tkhr
蝏	tkid
耓	tkld
㹶	tkqr
甼	tktd
筳	tkvr
誔	tkyr
痶	tmbb
鷆	tmbn
捵	tmfb
㶺	tmhk
㧂	tmht
䄽	tmhx
䡘	tmit
錪	tmjb
䥖	tmjd
觍	tmle
䐌	tmlo
賟	tmob
睓	tmob
舚	tmqk
䋬	tmsx
㙉	tmtb
鴫	tmtn
碵	tmub
璳	tmwb
琠	tmwb
㥏	tmxb
悿	tmxx
䚶	tmyt
䯾	tnak
䒒	tncd
蓨	tnco
㟘	tnek
螩	tnim
樤	tnmm
脁	tnod
旫	tnod
䩦	tnrg
鎥	tnrj
鋚	tnrj
趒	tntd
䟭	tnzv
毤	tobm
㼠	tobw
䓕	toce
涶	todi
沰	todu
挩	tofe
鼧	tojb
咃	toky
驒	toma
騨	toma
䴱	tomb
楕	tomo
馲	tomq
䭾	tomq
㸰	tonb
嫷	tono
袉	topb
袥	topu
狏	toqy
堶	toto
毻	toum
䍫	toyb
跅	tozi
䩞	tpgk
蛈	tpiu
呫	tpkk
䵊	trdb
䵯	trhv
檲	trmc
䊜	trmc
痌	tsbk
䆚	tsbk
㸗	tsbk
蓪	tscy
浵	tsdp
庝	tsgd
炵	tshd
秱	tshk
蚒	tsid
衕	tsii
㠽	tsjd
鉵	tsji
勭	tsll
氃	tslm
䴀	tsln
㼿	tslw
粡	tsmk
䮵	tsml
樋	tsmy
眮	tsok
膧	tsol
朣	tsol
狪	tsqk
綂	tsse
䂈	tssi
赨	tsti
餇	tsuk
䶱	tswa
痜	tubj
鶟	tubn
瘏	tubo
莵	tucd
蒤	tuch
鵵	tudn
湥	tudq
捈	tufh
庩	tugh
䩣	tugh
廜	tugo
䅷	tuhh
鈯	tuji
鋵	tujj
鼵	tujq
唋	tukh
圗	tukk
嵞	ture
䣄	ture
圡	tutd
㐋	tutv
䣝	tuue
筡	tuvh
㻯	tuwh
怢	tuxu
䤅	tuyd
䛢	tuyj
迌	tuzo
㿗	tvbb
藬	tvcb
㱣	tvdn
㢈	tvgf
㢑	tvgu
䅪	tvhr
㥆	tvxn
尵	tvyb
黗	tyht
㬿	tyow
豘	tyut
憞	tyxw
蘣	tzcv
㳆	tzdu
䵉	tzgd
㢏	tzgd
㼥	tzlw
婾	tznv
紏	tzsu
䞬	tztn
䚵	tzyu
率	uk
鯋	uaau
萐	uacr
蔱	uacy
㵤	uadr
毮	uafm
䬊	uajr
㠺	uaju
喢	uakj
㰼	uakr
唦	uaku
樧	uamy
倽	uark
儍	uarw
繺	uash
繌	uasw
䝊	uaur
箑	uavr
鮹	uca
髾	ucao
萔	ucck
莦	ucco
潲	ucd
綤	ucdx
旓	ucfo
烧	uch
輎	ucio
颵	ucjo
娋	ucno
焽	ucoh
䏴	ucoo
㪢	ucpy
筲	ucv
攦	udfb
㩄	udfx
㬠	udo
籭	udvb
簁	udvr
蔎	uec
㵃	uedb
奓	uedx
輋	uee
捨	uefk
摵	uefx
弽	uegm
蠂	ueim
蛥	ueix
虵	ueiy
䞌	uekk
欇	ueme
檨	uemr
賖	ueo
㓭	ueod
䄕	uept
舎	uerk
䜓	ueym
鯓	ufau
魫	ufav
覾	ufbe
蔘	ufcp
薓	ufcy
渖	ufd
峷	ufeu
弞	ufgr
呻	ufk
㕥	ufkr
籶	ufmj
䯂	ufmm
椮	ufmp
㰂	ufmt
兟	ufne
妽	ufnu
脤	ufon
祳	ufpn
侺	ufrv
罧	ufsm
堔	uftm
甡	ufu
鵢	ufun
诜	ufy
䱆	ugaz
蕂	ugcl
苼	ugcu
渻	ugdo
殅	ugdu
陹	ugeo
阩	ugeu
焺	ughu
㗂	ugko
呏	ugku
橳	ugml
䞉	ugob
榺	ugom
琞	ugoy
剰	ugqd
偗	ugro
縄	ugsd
䚇	ugue
䲼	ugun
㼳	uguw
憴	ugxa
曻	ugyl
鬺	uhaw
蔏	uhck
䵰	uhhw
螪	uhik
贘	uhob
仩	uhru
鲺	uia
鰤	uiaj
亊	uial
鰘	uiat
鮖	uiau
冟	uibb
䙾	uibe
寔	uibr
释	uic
蒒	uicj
䒨	uicu
葹	uicy
䏉	uieh
兘	uiek
峕	uieo
䦹	uieu
拭	uif
䗐	uifi
㸷	uifn
炻	uih
戺	uihs
鼭	uijc
史	uik
呩	uikx
枾	uiml
柹	uimp
䊓	uimr
榁	uimt
姼	uinx
䁺	uiog
眂	uiou
睗	uiow
㒾	uioy
失	uip
襫	uip
釈	uipi
舓	uiqw
䌤	uisx
䂖	uiud
丗	uiuk
簭	uivk
瓧	uiwa
试	uiy
遈	uizr
鳣	ujaa
䱇	ujad
䱉	ujaq
鯅	ujav
痁	ujbk
芟	ujc
㨛	ujfr
挻	ujfv
搧	ujfx
煽	ujh
炶	ujhk
熌	ujhr
蟺	ujid
钐	ujj
嘇	ujkp
㣌	ujlp
杣	ujme
檆	ujmk
嬗	ujnd
曑	ujop
脠	ujov
䄠	ujpd
彡	ujpp
䘰	ujpv
狦	ujqc
㺑	ujqp
傓	ujrx
剼	ujsd
縿	ujsp
圸	ujte
墠	ujtu
磰	ujuk
鄯	ujy
敾	ujyw
帅	ukl
卛	uks
缞	uksy
㲤	ukwm
䢦	ukz
䝄	ulay
䫪	uldb
鷞	uldn
灀	uldo
㕠	uldy
䗮	ulix
樉	ulmx
孇	ulny
縔	ulsm
䌮	ulso
塽	ultx
艭	ulvy
﨎	ulwy
欶	uoa
愬	uobx
洬	uodd
鎙	uojo
㮶	uomo
䀥	uoo
䁻	uoom
獡	uoqh
矟	uos
箾	uovd
䧠	ure
槫	urmc
鱰	uuao
䜹	uuau
鮛	uuax
殊	uud
濖	uudo
潄	uudw
掓	uufy
秫	uuh
稌	uuhh
蠴	uuio
軗	uuiy
殳	uuj
鏣	uujh
䑕	uujl
糬	uumo
柕	uump
㛸	uuna
㫹	uuoj
㽰	uuor
裋	uupa
襩	uupb
㸡	uupv
侸	uura
倐	uurh
悆	uurx
䞖	uuty
朮	uuud
尗	uuux
孰	uuw
瑹	uuwh
䢞	uuzm
㽷	uvbu
捝	uvfe
䳠	uvin
㥨	uvnx
脽	uvof
裞	uvpe
䭨	uvuk
誜	uxww
鬊	uya
蕣	uycl
䑞	uykl
瞚	uyob
眴	uyoo
䀢	uyou
瞤	uyow
䴄	uypn
䭭	uzbb
涭	uzdy
㧃	uzfl
膄	uzo
敊	uzuy
艏	uzv
収	uzvy
魦	uaau
㲚	uadm
㸺	uadn
硰	uadu
乷	uadv
挱	uafu
帹	uajn
䤬	uaju
閯	uamu
粆	uamu
榝	uamy
㰱	uaqr
猀	uaqu
䈉	uavn
剎	uaxd
翣	uaxn
閷	uaxr
翜	uaxr
蕱	ucco
䔠	ucco
䒚	uccu
卲	ucde
䙼	ucde
弰	ucgo
焼	uchw
袑	ucpk
㸛	ucpk
䬰	ucuk
㲈	ucuk
䈾	ucvo
䈰	ucvo
㴓	uddx
䵘	udhw
簛	udvj
涻	uedk
渉	uedu
摂	uejn
䤮	uejp
韘	uelm
騇	uemk
䀅	uepm
㴇	ueuu
䠶	ueuu
䬷	ueux
鰰	ufau
䆦	ufbh
罙	ufbm
穼	ufbm
宷	ufbm
㾕	ufbu
邥	ufde
㚞	ufdm
昚	ufdo
眘	ufdo
涁	ufdp
㵕	ufdx
扟	uffu
抌	uffv
矤	ufgu
䰠	ufgu
䅸	ufhu
黮	ufhv
頣	ufib
㰮	ufir
鋠	ufjn
鉮	ufju
㜪	ufln
駪	ufme
㮱	ufme
柛	ufmu
榊	ufmu
籸	ufmu
姺	ufne
㚨	ufnu
曋	ufou
眒	ufou
裑	ufpu
氠	ufqu
㑗	ufru
甧	ufuo
愼	ufxb
訠	ufyl
谉	ufyu
訷	ufyu
㾪	ugbo
㱡	ugde
湦	ugdu
泩	ugdu
䴤	uggu
﨡	ugiu
鼪	ugju
鍟	ugju
鉎	ugju
竔	uglu
㮐	ugmo
枡	ugmu
鵿	ugnu
晠	ugoi
貹	ugou
䪿	ugpb
狌	ugqu
䁞	ugro
墭	ugtm
珄	ugwu
斘	ugxu
譝	ugya
滳	uhdk
漡	uhdw
鞝	uhgk
扄	uhhk
鑜	uhjb
丄	uhla
䵼	uhpv
恦	uhxk
尙	uhxk
慯	uhxw
愓	uhxw
謪	uhyk
鳾	uian
宲	uibm
宩	uibm
溡	uidc
澨	uidr
㵓	uidr
㳏	uidu
湤	uidy
嵵	uiec
崼	uier
銴	uifj
揓	uify
觢	uify
烒	uihg
煶	uihr
䄷	uihu
徥	uiir
㱁	uiir
䖨	uiiu
鉽	uijg
䤱	uijj
䤭	uijj
鉐	uijk
鉃	uiju
鉂	uiju
鍦	uijy
鉇	uijy
釶	uijy
兙	uike
呞	uikk
㖷	uikr
竍	uilu
䩃	uimb
榯	uimc
檡	uimg
嬕	uing
鶳	uinj
襹	uipb
褷	uipr
㹬	uiql
㹝	uiqu
佦	uiru
乨	uisv
絁	uisy
䌳	uisy
餝	uiuf
餙	uiuj
䭄	uiul
卋	uiun
䲽	uiun
㔺	uiuu
䂠	uiuu
乭	uiuv
㐊	uiuv
䶡	uivd
籂	uivj
篒	uivl
旹	uivo
䈕	uivr
笶	uivu
箷	uivy
㕜	uivy
瑡	uiwj
忕	uixd
弒	uixg
㹷	uixq
恀	uixx
諟	uiyr
䛈	uiyu
遾	uizr
辻	uizu
䟗	uizu
潬	ujda
灗	ujdd
㶒	ujdm
澘	ujdo
㚒	ujdr
㴸	ujdr
㪎	ujdy
邖	ujee
覢	ujhe
煔	ujhk
軕	ujie
㣣	ujir
䡪	ujix
銏	ujjc
䦅	ujjk
鐥	ujjk
幓	ujjp
䦂	ujjx
䥇	ujjx
樿	ujma
閊	ujme
䴮	ujme
椫	ujml
㰑	ujmm
睒	ujoh
䀐	ujop
僐	ujrk
赸	ujte
饍	ujuk
䠾	ujur
笘	ujvk
譱	ujyk
䚲	ujyp
歚	ujyr
謆	ujyx
羴	ujyy
㪨	ujyy
㦼	ulfg
鏯	uljx
騻	ulmx
欆	ulmy
䉶	ulvy
慡	ulxx
哾	uoke
鱪	uuao
䱙	uuay
㾁	uubu
癙	uubv
薥	uuci
藷	uuco
蒁	uucu
荗	uucu
瀭	uudd
㶖	uudh
㵂	uudh
潻	uudu
捒	uufu
䩱	uugd
庻	uugr
虪	uuhh
䝂	uuia
㷂	uuih
㡏	uujd
錰	uujh
鉥	uuju
咰	uuko
毺	uumd
䴰	uumg
㯮	uumi
橾	uumm
杸	uumy
㜐	uuna
㣽	uunx
暏	uuoo
䝪	uuor
襡	uupi
䘤	uupu
焂	uurh
儵	uurh
㒔	uuri
鵨	uurn
跾	uurr
㑐	uurx
絉	uusu
綀	uusu
尌	uuuc
䠼	uuud
怷	uuux
䉀	uuvh
疎	uuvu
籔	uuvw
㼡	uuvw
璹	uuwc
㻿	uuwi
䃞	uuwu
鼡	uuxl
䨹	uuyh
鶐	uuzn
踈	uuzu
䢤	uuzu
涗	uvde
涚	uvde
閖	uvmu
祱	uvpe
䬽	uvue
㕞	uxuy
橓	uyml
䀵	uyou
㥧	uyxb
痩	uzby
㝊	uzby
鏉	uzjr
㖟	uzky
垨	uztc
獣	uzxq
㥅	uzxy
䛵	uzyy
𦔯	uabe
𦯬	uecx
𨛭	uere
张	vh
之	vi
䱹	vaag
鮓	vaav
䆛	vabq
宱	vabv
苲	vac
䕢	vacg
觰	vado
搩	vafm
㡸	vag
煠	vahm
灹	vahq
皻	vahy
䖳	vaiq
咤	vak
耫	valb
甴	vall
查	vam
蚻	vami
䮜	vamm
柤	vamq
皶	vamy
䐒	vaox
偧	var
䋾	vasx
皼	vauy
箚	vavd
䶥	vavq
㦋	vaxo
怍	vaxv
㷢	vayh
譇	vayo
醡	vayv
齄	vazd
迊	vazj
踷	vazo
鮡	vca
巶	vcds
盄	vcgm
枛	vcmv
妱	vcnk
㐍	vcpv
爫	vcpx
狣	vcqd
㑿	vcrg
佋	vcrk
䍜	vcsf
羄	vcsu
箌	vcvd
䈃	vcvk
瑵	vcwi
䍮	vcyd
䔝	vdcx
抧	vdfb
捚	vdfl
擿	vdfz
㡯	vdgq
厏	vdiv
粂	vdjm
榸	vdml
䐱	vdo
㒀	vdrk
亝	vdse
砦	vdvk
斏	vdwl
夈	vdwm
斎	vdwx
䝃	vea
鮿	veav
䓆	vecj
䎲	vee
埑	veft
悊	vefx
䩾	vegh
㢎	vegj
䜆	vegk
虴	veiq
輙	veiy
啠	vejk
銸	vejv
㪿	vekj
乽	velv
棏	vemc
樜	vemh
籷	vemq
㭯	vemv
嫬	ven
䐲	veo
晣	veoj
䐑	veom
襵	vepe
㸞	vepp
螫	vet
謺	vetk
矺	veuq
砓	veuy
鱵	vfak
䪾	vfap
眞	vfbb
蒖	vfcb
萙	vfcv
薽	vfcw
浈	vfd
聄	vfep
塦	vfet
搸	vffh
挋	vffi
䳲	vffn
抮	vffp
弫	vfgi
黰	vfhb
䲴	vfhn
蜄	vfin
䑐	vfix
鋴	vfje
錱	vfjw
㯢	vfmb
駗	vfmp
栚	vfmt
樼	vfmz
嫃	vfnb
䏖	vfol
眹	vfot
裖	vfpn
獉	vfqh
㪛	vfqy
侲	vfrn
㐱	vfrp
敒	vfrw
縥	vfsh
紾	vfsp
䊶	vfsy
䂦	vfup
䃌	vfut
䂧	vfux
臻	vfv
䈯	vfvb
籈	vfvw
瑧	vfw
珎	vfwx
誫	vfyn
䨯	vfyo
遉	vfzb
䟴	vfzn
鬇	vgal
㱏	vgav
崝	vgeo
聇	vgev
揁	vgfb
徰	vgiv
徵	vgiw
㡠	vgja
䦶	vgml
愸	vgmx
媜	vgnb
㬹	vgol
眐	vgov
晸	vgow
䥭	vgqj
佂	vgrv
䋊	vgs
糽	vgsd
䋫	vgsl
鴊	vgvn
䈣	vgvw
憕	vgxa
踭	vgzl
鱆	vhau
瘬	vhbd
㽴	vhbv
蔁	vhcu
扙	vhfv
弡	vhgj
㕩	vhkf
鄣	vhl
粻	vhmd
长	vhp
傽	vhru
㙣	vhtd
䛫	vhyd
遧	vhzu
鯯	viad
臸	viat
䱃	viau
痔	vib
㽻	viby
䕌	vicf
䓡	vick
䓋	vicu
藢	vicw
䓌	vicx
洷	vidt
聁	vied
聀	vieg
摭	vif
抧	vifb
䭁	vifl
捗	vifp
㨁	vifq
挃	vift
㡶	vigb
庢	vigt
䅩	vihb
穉	vihn
秷	viht
徏	viip
徝	viiq
轾	viiv
憄	viix
铚	vij
劕	vijd
只	vik
㗌	vikt
馶	vimy
㜱	vinb
娡	vinx
胑	viob
䝰	vioc
膱	viog
䐭	vioj
㫑	viol
䐈	vioq
膣	viov
䞃	viow
䏯	viox
㸟	vipo
禃	vipq
祬	vipt
襧	vipx
衼	vipy
狾	viqj
豑	viqp
儨	virb
偫	virc
倁	virk
値	virq
俧	virx
緻	visw
綕	visx
䲀	vita
䟈	vitw
慹	vitx
礩	viub
鳷	viun
䬹	viut
致	viv
臸	vivt
䉅	vivw
瓆	viwb
袠	viwy
恉	vixo
謢	viyy
趾	viz
㝂	vizj
鱣	vjad
䱳	vjal
䱼	vjan
菚	vjcg
薝	vjck
嶘	vjeg
嶃	vjej
嶦	vjek
嵁	vjev
䪌	vjgd
㠭	vjgg
虦	vjgj
䆄	vjhd
虥	vjhg
黵	vjhk
㣶	vjid
蛅	vjik
轏	vjiz
噡	vjkk
栈	vjm
閚	vjml
榐	vjmn
嫸	vjnk
㜊	vjnn
䁴	vjod
䁪	vjoj
䘺	vjpr
㺘	vjqh
饘	vjud
㞡	vjuy
战	vjv
琖	vjwg
皽	vjwy
戦	vjxg
醆	vjyg
譧	vjyn
讝	vjyw
蹍	vjzn
睉	vko
跩	vkz
跩	vkzy
荘	vlcu
湷	vldo
漴	vldx
焋	vlph
娤	vlpn
窡	vob
䆯	vobn
䕴	voch
斮	vocj
㧻	vofd
鷟	vofn
擆	vofo
穱	vohc
燋	vohh
炪	vohi
彴	voi
䪼	voib
蠗	voif
䶂	voju
啅	voku
斱	volj
鵫	voln
棹	vom
㭬	vomu
棳	vomy
妰	von
娺	vony
䐁	vood
斵	vopj
㺟	voqf
㑁	vori
㒂	voro
劅	vosd
罬	vosy
圴	vot
硺	voud
㓸	vovd
篧	vovf
斲	vovj
㣿	voxu
丵	voyg
謶	voyh
䟾	vozy
鱄	vrac
鄟	vrae
䧘	vreu
蟤	vrib
䡱	vrik
竱	vrlc
嫥	vrn
膞	vroc
襈	vrp
僎	vrr
縳	vrs
叀	vrus
籑	vrvl
瑼	vrwc
䱰	vsav
瘇	vsbv
泈	vsdd
汷	vsdw
炂	vshs
蚣	vsi
彸	vsis
鼨	vsjd
鴤	vsnd
祍	vspr
衳	vsps
祌	vspv
㹣	vsqd
狆	vsqv
伀	vsrs
刣	vssd
塚	vstn
堹	vstv
舯	vsv
䈺	vsvd
䝦	vsvn
螤	vswr
尰	vsyv
蹱	vszl
鱁	vuau
鮢	vuav
茿	vucf
芧	vucl
藸	vuco
蓫	vucu
潴	vud
㵭	vudh
陼	vueo
嵀	vuev
䍆	vufd
㧣	vufv
麆	vugq
爥	vuhi
蝫	vuio
䥮	vuje
䪒	vulv
欘	vumi
株	vumn
眝	vuod
曯	vuoi
䐗	vuoo
䐢	vuop
䝬	vuov
袾	vupv
助	vuq
橥	vuq
㺛	vuqc
鸀	vusn
罜	vusv
劚	vuud
櫫	vuum
䝒	vuun
䃴	vuuo
邾	vuv
鴸	vuvn
䇬	vuvv
㤖	vuxd
躅	vuz
㚝	vvdt
鑆	vvjc
䶆	vvjf
㗓	vvkk
鵻	vvnf
膇	vvo
䄌	vvpy
畷	vvty
笍	vvvn
䨨	vvyk
挝	vxf
檛	vxmk
膼	vxo
簻	vxvk
淳	vydz
稕	vyhz
㡒	vyjo
啍	vykz
綧	vysz
圫	vytq
忳	vyxt
迍	vyzt
鯞	vza
㾭	vzbh
葤	vzcc
菷	vzcj
䓟	vzck
淍	vzdk
䎻	vzek
㨄	vzfk
炿	vzhd
甃	vzhw
昼	vzi
徟	vzik
䶇	vzjo
銂	vzjv
㼙	vzjw
嚋	vzkc
呪	vzke
噣	vzki
咮	vzkv
椆	vzmk
粙	vzmy
㛩	vzno
㫶	vzoj
晭	vzok
	vzrp
侜	vzrv
僽	vzrx
伷	vzry
矪	vzuv
䈙	vzvc
䑼	vzvp
䎇	vzvx
珘	vzwv
㥮	vzxp
霌	vzyk
㾴	vabd
㴙	vadj
㱜	vadr
㳐	vadv
抯	vafq
䵙	vahx
㪥	vahy
䥷	vajd
䮢	vamj
樝	vamq
䄍	vapo
㗬	vaxx
䛽	vayj
譗	vayk
窼	vcbg
㐒	vcdv
罀	vcfd
㡽	vcgy
燳	vchh
㷹	vchu
肈	vchy
肁	vchy
鍣	vcjk
鉊	vcjk
駋	vcmk
瞾	vcog
㷖	vcok
垗	vctd
䞴	vctk
䃍	vcuu
䑲	vcvu
䈇	vcvu
䝖	vcvv
䍉	vdfb
㩟	vdfm
鉙	vdjb
檡	vdmg
㸙	vebo
淛	vedd
歽	vedj
䵭	veho
蟅	veih
厇	veiq
㡇	vejv
㭙	vemc
䮰	vemk
䊞	vemk
粍	vemm
㯰	vemq
馲	vemq
㯙	vemw
䏳	veoj
袩	vepk
䝕	veue
㞏	veuf
嚞	veuk
䂞	veum
䇽	vevj
䠦	vezo
䫬	vfab
寊	vfbb
䪴	vfdb
覙	vfde
殝	vfdh
澵	vfdj
潧	vfdo
㴨	vfdt
㱽	vfdy
㣀	vfgb
㼉	vfgv
轃	vfih
㲀	vfiy
鎭	vfjb
帪	vfjn
鉁	vfjp
辴	vfkn
㖘	vfkn
栕	vfmi
桭	vfmn
㮳	vfmt
姫	vfni
䀕	vfol
眕	vfop
䝩	vfop
絼	vfsv
㓄	vfsv
甽	vfti
㘰	vftu
䠴	vful
屒	vfun
碪	vfuv
靕	vfvo
酙	vfyu
䱢	vgal
䆸	vgba
䥌	vgbj
㽀	vgbw
塣	vgdt
撜	vgfa
抍	vgfu
炡	vghv
䡕	vgia
徴	vgiw
㡧	vgja
凧	vgjj
氶	vgln
䦛	vgml
姃	vgnv
埩	vgtl
䂻	vgud
䇰	vgva
篜	vgvh
䍵	vgyl
痮	vhbd
涱	vhdd
鞝	vhgk
麞	vhgu
幥	vhju
鏱	vhju
鐣	vhju
騿	vhmu
粀	vhmv
瞕	vhou
墇	vhtu
餦	vhud
礃	vhuu
慞	vhxu
寘	vibb
疻	vibb
疷	vibd
㿃	vibj
鴲	vibn
芖	vicd
䓜	vicd
蘵	vicg
洔	vidc
瀄	vide
䚦	vidj
潪	vido
㴯	vido
潌	vidt
觗	vidu
汦	vidu
淽	vidv
㴛	vidw
汥	vidy
崻	viec
䎺	vied
剬	vied
隲	viem
豒	viep
阤	viey
擳	vife
旘	vifg
搘	vifo
扻	vifr
搱	vifu
㨖	vifw
廌	vigh
䩢	vigj
㡳	vigu
秲	vihc
秪	vihd
熫	vihh
䆈	vihn
稺	vihu
秖	vihu
秓	vihy
䄺	vihy
㣥	viic
蟙	viig
䛗	viik
䡹	viir
厔	viit
徔	viiv
㕄	viiy
釞	vijr
䤠	vijv
鋕	vijx
㘉	vike
㗧	vikt
郦	vile
戠	vilg
櫍	vimb
㯄	vimb
楖	vime
樴	vimg
椥	vimk
䵂	vimk
駤	vimt
柣	vimu
馽	vimv
䦯	vimw
㮹	vimw
䳅	vinb
嬂	ving
㛿	vinj
㜼	vinq
妷	vinu
䑇	viob
䱥	vipa
禵	vipb
䘭	vipt
祑	vipu
乿	vipv
猘	viqd
傂	virj
紩	visu
瓡	vitg
墌	vith
㙷	vith
墆	vitj
䥍	vitj
坧	vitk
䞠	vitk
驇	vitm
騺	vitm
垁	vitu
坁	vitu
漐	vitu
鼅	viua
䵹	viua
䝷	viub
覟	viue
䧴	viuf
軄	viug
帋	viuj
劧	viul
㲍	vium
㲛	vium
鴙	viun
砋	viuv
䣽	viuy
貭	vivb
筫	vivb
䉜	vivf
䇧	vivk
䇛	vivv
懫	vixb
㥀	vixq
懥	vixr
翐	vixu
㩼	vixy
訨	viyv
䚳	viyy
䟡	vizd
迣	vizu
䱠	vjag
魙	vjdg
惉	vjdx
㟞	vjeg
岾	vjek
旜	vjfd
覱	vjie
輚	vjig
䗃	vjig
驙	vjmd
㮵	vjmd
桟	vjmg
橏	vjmk
䩇	vjmk
䦓	vjmk
䩆	vjmv
䩅	vjmy
䋎	vjsd
趈	vjtk
䟋	vjtk
䡀	vjud
飦	vjug
䶨	vjvr
㔊	vjwd
㻵	vjwz
䎒	vjxg
詀	vjyk
邅	vjzd
庒	vlgd
戅	vllx
糚	vlmu
梉	vlmu
壵	vluu
窧	vobu
灂	vodc
撯	vofo
㧳	vofu
穛	vohh
䅵	vohh
烵	vohu
鐯	vojo
梲	vome
槕	vomm
櫡	vomo
䮓	vomu
䮕	vomy
犳	voqu
㹿	voqu
斀	vosy
䂐	voui
籱	vovf
籗	vovf
琸	vowu
䫎	voyb
蠿	voyi
諁	voyy
蒃	vrcu
灷	vrhc
転	vris
堟	vrtu
磗	vruc
専	vruc
䉵	vrvl
譔	vryb
諯	vrye
孨	vrzz
蔠	vscd
煄	vshv
蚛	vsiv
㣫	vsiv
幒	vsjx
喠	vskv
妐	vsns
媑	vsnv
妕	vsnv
衶	vspv
㲴	vsqv
偅	vsrv
䇗	vsvs
筗	vsvv
歱	vsvv
籦	vsvv
諥	vsyv
迚	vszv
鯺	vuao
㝉	vuba
㾻	vubh
窋	vubi
㿾	vubm
宔	vubv
䕽	vuci
莇	vucl
灟	vudi
泏	vudi
濐	vudo
㶆	vudo
䎷	vuev
㫂	vugj
䰞	vugl
炢	vuhu
秼	vuhv
蠾	vuii
蠩	vuio
軴	vuiv
鋳	vujc
钃	vuji
鉒	vujv
竚	vuld
煑	vulh
䡤	vuli
䘄	vuli
䬡	vull
馵	vumc
䮱	vumu
樦	vumv
駯	vumv
孎	vuni
䘢	vupd
祩	vupv
㹥	vuqv
㑏	vurc
䌵	vusi
紸	vusv
絑	vusv
坾	vutd
䟉	vuti
墸	vuto
壴	vuua
㔉	vuud
䭖	vuuh
斸	vuuj
劯	vuul
飳	vuuv
鼄	vuva
䇡	vuvd
笁	vuvg
㦵	vuvg
笜	vuvi
筯	vuvl
篫	vuvu
䇠	vuvv
殶	vuvy
䘚	vuwu
詝	vuyd
羜	vuyd
霔	vuyv
䣷	vuyv
䠱	vuzi
跦	vuzv
迬	vuzv
跓	vuzv
㾽	vvbk
轛	vvic
甀	vviw
㩾	vviy
錣	vvjy
㮅	vvmf
娷	vvni
硾	vvui
礈	vvuu
沝	vvuu
餟	vvuy
諈	vvyi
醊	vvyy
宒	vybm
凖	vydu
埻	vytz
訰	vyyt
疛	vzbc
䧓	vzek
䩜	vzgy
烐	vzhv
䖞	vzic
輖	vzik
郮	vzke
喌	vzkv
騆	vzmk
駲	vzmv
駎	vzmy
睭	vzok
㑳	vzrp
䋓	vzse
盩	vztm
箒	vzvj
籕	vzvt
籒	vzvt
诪	vzyc
詋	vzye
冑	vzyo
䛆	vzyy
𤙔	vcn_
𤩄	vrwb
邷	waae
溛	wadg
漥	wadt
聉	waei
䎳	waeo
㼘	waew
搲	wafg
㧚	wafw
韈	wag
徍	wait
嗢	wakm
啘	wakv
咓	wakw
婠	wank
屲	wape
鼃	wata
劸	watl
砙	wauw
邷	wawe
瓲	wawt
瓲	wawv
䍪	waym
䚴	wayo
䨟	wayt
䠚	wazg
㖞	wdkn
㗏	wdkv
顡	wdlb
䴜	wdlg
竵	wdll
䶐	wdzo
魰	wfaw
顐	wfbb
㝧	wfbt
䎽	wfe
鞰	wfgm
鼤	wfjw
呡	wfkm
㗃	wfko
呚	wfkw
桽	wfmt
妏	wfnw
肳	wfo
㼔	wfog
脗	wfok
昷	wfom
䐇	wfoo
脕	wfov
䎹	wfpe
缊	wfsm
絻	wfsv
豱	wfum
蚉	wfwi
韫	wfwm
鴍	wfwn
彣	wfwp
㐎	wfwv
䱵	wga
攚	wgfk
奣	wgg
䩺	wggx
螉	wgi
㘢	wgkw
㮬	wgmx
㜲	wgnf
㹙	wgno
瞈	wgox
奣	wgto
塕	wgtx
齆	wgzb
尣	whbe
菵	whcw
莣	whcx
㲿	whdg
㴏	whdw
䰣	whgx
焹	whhw
蛧	whix
暀	whov
盳	whow
仼	whrw
亾	whvr
迋	whzw
剜	wjb
涴	wjdv
汍	wjdw
潫	wjdx
㝴	wjec
刓	wjed
抏	wjfe
帵	wjjv
錽	wjjw
㘤	wjka
㜶	wjnd
贃	wjox
贎	wjoy
䘼	wjpv
倇	wjrv
埦	wjtv
毌	wjva
卐	wjvv
笂	wjvw
琓	wjwe
忨	wjxe
䛷	wjyv
踠	wjzv
䰀	woa
㠛	woe
捾	wofk
㧴	wofw
馧	woh
喎	wok
唩	wokn
楃	wom
枂	womo
媉	won
婑	wonn
䀑	wooi
瞃	wooo
腛	woot
臒	wooy
猧	woqk
㹻	woqn
瓁	wowy
䠎	wozt
鰞	wuah
鯃	wuak
痦	wub
蘁	wuck
莁	wucr
茣	wuct
浯	wud
㵲	wudl
洿	wudv
嵨	wueh
阢	wuev
阢	wuew
庑	wug
弙	wugy
焑	wuhm
铻	wuj
鼯	wuj
䑁	wujo
錻	wujv
杌	wum
㮧	wumh
䦍	wumq
妩	wun
瞴	wuoh
歍	wupr
祦	wupt
甒	wupw
禑	wupy
俉	wurk
儛	wurl
倵	wurv
奦	wusd
敄	wusw
剭	wuud
呉	wuvb
箼	wuvt
吾	wuw
㻍	wuwt
怃	wuxv
逜	wuzk
躌	wuzl
鳂	wwa
鮠	wwav
鮇	wwaw
蓶	wwcf
蒍	wwch
藯	wwcx
芛	wwcy
涠	wwd
頠	wwdb
䧦	wweh
隗	wwes
隈	wwew
捤	wwfm
揋	wwfn
㨊	wwfo
廆	wwg
䪋	wwgb
骪	wwgf
軎	wwgk
䴧	wwgn
煟	wwh
䫋	wwhb
煀	wwhi
烓	wwht
轊	wwie
讏	wwik
蝛	wwin
蝟	wwio
㣲	wwiw
鏏	wwje
䬑	wwjo
䪘	wwlr
椲	wwml
媦	wwno
䑊	wwob
㬙	wwoh
暐	wwol
腲	wwon
覹	wwow
鄬	wwpe
䙟	wwpl
罻	wwsc
縅	wwsn
墛	wwtc
㙔	wwtl
壝	wwtz
䬿	wwum
饖	wwup
玮	www
璏	wwwb
䙿	wwwe
惟	wwx
懀	wwxo
醀	wwyf
詴	wwyo
踓	wwzf
攨	wafg
䯉	wagr
嗗	wakg
䵷	wata
䠿	wdub
䰚	wfaw
瘒	wfbi
莬	wfcv
殟	wfdm
渂	wfdw
搵	wffm
抆	wffw
穏	wfhx
鎾	wfjm
㡈	wfjv
鈫	wfjw
闦	wfma
蟁	wfmi
榲	wfmm
閺	wfmw
馼	wfmw
駇	wfmw
闅	wfmy
㬈	wfom
塭	wftm
饂	wfum
螡	wfwi
䘇	wfwi
瑥	wfwm
鳼	wfwn
珳	wfwp
忟	wfxw
勜	wgbl
嵡	wgex
聬	wgex
鎓	wgjx
暡	wgox
䐥	wgox
㺋	wgqx
䈵	wgvx
㓁	whbe
尩	whbw
䒽	whcx
瀇	whdb
㳹	whdw
徃	whiu
蚟	whiw
彺	whiw
蝄	whiw
棢	whmw
罖	whsd
䋄	whsx
䋞	whsx
兦	whvr
尫	whww
忹	whxw
䤑	whyb
誷	whyw
㸘	wjbd
䗕	wjbi
萖	wjce
薍	wjcv
澫	wjdy
岏	wjee
捖	wjfe
捥	wjfv
䯈	wjge
䯛	wjgv
䅋	wjhv
輐	wjie
䘎	wjig
鋔	wjjv
鎫	wjjw
䥑	wjjw
鋄	wjjy
唍	wjke
梚	wjmv
䩊	wjmv
杤	wjmw
䳃	wjnv
貦	wjoe
晼	wjov
睕	wjov
晩	wjov
䝹	wjov
綩	wjsv
絻	wjsv
䑱	wjvv
㿸	wjvy
翫	wjxe
邜	wjxe
䖤	wjxi
盌	wjxm
㽜	wjxt
䛃	wjye
涹	wodn
濣	wodu
㱧	wodv
捰	wofg
焥	wohv
䮸	wojm
婐	wong
䁊	wooo
仴	woro
䂺	woug
兀	wuae
㽾	wubi
窹	wubk
窏	wuby
䓊	wuck
溩	wudh
潕	wudh
鴮	wudn
洖	wudt
䎸	wuek
岉	wuew
摀	wufh
扤	wufw
熓	wuhh
䖚	wuhh
㷻	wuhh
螐	wuih
䡧	wuih
釫	wujk
䫓	wulb
杇	wumk
䦜	wumk
䮏	wumk
䳇	wumn
粅	wumw
娪	wunk
㬳	wuow
橆	wupm
鷡	wupn
㹳	wuqk
㒇	wurh
㑄	wurm
伆	wurw
㐳	wurw
嵍	wuse
䨁	wusf
熃	wush
䍢	wush
㡔	wusj
䳱	wusn
䃖	wuuh
碔	wuuv
矹	wuuw
䉑	wuvh
䒉	wuvl
瑦	wuwh
璑	wuwh
啎	wuwk
卼	wuwv
㐚	wuwv
㐏	wuwv
玝	wuww
忢	wuwx
悞	wuxd
悮	wuxt
䛩	wuya
譕	wuyh
誈	wuyt
霚	wuyw
䜑	wuyx
䟼	wuzv
鼿	wuzw
齀	wuzw
趶	wuzy
䲁	wwac
鰄	wwan
寪	wwbh
癐	wwbo
痏	wwbo
癓	wwbw
蘶	wwcg
蔿	wwch
荱	wwcm
葨	wwcn
䵋	wwco
䔺	wwco
菋	wwcw
苿	wwcw
瀢	wwdb
濻	wwdb
沩	wwdd
厃	wwdi
湋	wwdl
浘	wwdm
渨	wwdn
㱬	wwdn
㠕	wweg
嵔	wwen
隇	wwen
崣	wwen
㟪	wwen
峞	wwev
嶶	wwew
熭	wwfh
揻	wwfn
骩	wwgj
骫	wwgw
覣	wwhe
犩	wwhn
䵳	wwho
䭳	wwho
燰	wwhw
蜼	wwif
䘙	wwii
讆	wwik
徫	wwil
蜲	wwin
㣦	wwin
躛	wwir
躗	wwir
㕒	wwiw
䡺	wwix
㦣	wwix
鍏	wwjl
颹	wwjl
鍡	wwjn
䥩	wwjw
喡	wwkl
喴	wwkn
㖐	wwky
韡	wwll
䦱	wwmh
欈	wwmk
梶	wwmm
䊊	wwmm
椳	wwmn
楲	wwmn
㮃	wwmn
䮹	wwmp
㭏	wwmw
媁	wwnl
媙	wwnn
㛱	wwnn
儰	wwrh
䗽	wwsi
䋿	wwsn
緭	wwso
䞔	wwtm
㙗	wwtn
㙎	wwtn
㷉	wwuc
屗	wwuc
䃬	wwug
犚	wwun
餧	wwun
䝐	wwuo
褽	wwuy
叞	wwuy
䈧	wwvh
䇻	wwvm
䉠	wwvw
斖	wwwq
愇	wwxl
韑	wwxl
愄	wwxn
㥜	wwxo
䜅	wwyf
䍷	wwyl
䍴	wwyn
㞇	wwyn
䜜	wwyo
霺	wwyw
兴	xk
训	xy
㔤	xbbl
潃	xbdo
阠	xbeu
邤	xbje
歆	xbl
馸	xbmj
枔	xbmv
杺	xbmx
妡	xbnj
㛛	xbnu
㚯	xbnx
盺	xboj
襑	xbpc
舋	xbpq
馫	xbqo
㐰	xbrk
伩	xbrw
忻	xbx
訫	xbyx
孞	xbzx
鯑	xiaj
鱚	xiak
壐	xiat
穸	xib
墍	xibt
菥	xic
蕮	xich
葈	xicm
葸	xics
薂	xicw
汐	xid
浠	xidb
渓	xidf
㚛	xido
觹	xidv
嵠	xied
䧍	xiek
㩗	xifn
扸	xifp
觋	xig
䊠	xigm
塈	xigt
烯	xihb
焈	xihh
燨	xihw
熙	xii
螅	xii
徯	xiid
蟢	xiik
唏	xik
㗩	xikb
嚱	xikg
煕	xikh
桸	ximj
橲	ximk
杫	ximv
牺	xin
㜯	xinh
㛭	xino
犠	xinw
晞	xiob
䐖	xiom
肹	xiov
㬛	xiox
禊	xip
熈	xiph
㰿	xipr
㺣	xiqg
狶	xiqj
氥	xiqx
俙	xirb
㑶	xirm
翖	xirx
縘	xisd
緆	xisw
赩	xitb
㚀	xitg
趇	xitl
赥	xitr
豨	xiub
矽	xiud
貕	xivd
恓	xix
慀	xixd
㦻	xixg
悕	xixj
忾	xixq
欷	xixr
躧	xizb
䶋	xizj
蹝	xizr
䣆	xkae
鯹	xkau
皨	xkbt
䕟	xkcb
莕	xkck
洐	xkdi
觲	xkdn
觪	xkdu
㨘	xkfo
䰢	xkgi
㷣	xkhn
㣜	xkid
䗌	xkiu
﨨	xkjg
㐩	xkjj
臖	xkjo
䤯	xkjp
哘	xkki
㼛	xkkw
嬹	xknb
䁄	xkog
侀	xkrd
緈	xksg
㙚	xktn
㼬	xktw
箵	xkvo
䛭	xkyg
䳙	xkyn
鱜	xlae
鱶	xlal
䢽	xlcb
勨	xldl
䴂	xldn
嶑	xlen
㟟	xles
㟄	xley
缿	xlfk
䖮	xlik
蟓	xlin
啌	xlkg
栙	xlml
姠	xlnk
膷	xlo
晑	xlok
䐟	xlor
襐	xlpn
佭	xlrl
儴	xlry
絴	xlsy
箱	xlv
㐔	xlwv
郷	xlxe
跭	xlzl
鱻	xmaa
䱤	xmaj
䯹	xmay
鶱	xmbn
㿌	xmbr
苋	xmc
藖	xmcb
䵌	xmcr
藔	xmcx
㶍	xmdy
陥	xmeo
䧮	xmex
㧥	xmfe
攇	xmfx
㡾	xmgg
韅	xmgh
韱	xmgj
婱	xmgn
廯	xmgy
馦	xmhn
贒	xmib
輱	xmik
䁂	xmio
㽉	xmiw
錎	xmjj
鏾	xmjw
㘋	xmkb
哯	xmke
㘅	xmki
咞	xmkk
唌	xmkv
㮭	xmmg
杴	xmmr
䩂	xmmv
櫶	xmmx
嬐	xmnr
妶	xmny
顕	xmob
盷	xmod
晛	xmoe
䂅	xmoi
䐄	xmoj
胘	xmoy
襳	xmpj
㸝	xmpr
褼	xmpv
玁	xmqw
僲	xmrl
僊	xmrv
絤	xmsx
垷	xmte
礥	xmub
筅	xmv
䉯	xmvb
㔾	xmvv
珗	xmwe
㰹	xmwr
㦓	xmxh
憪	xmxo
㦑	xmxw
䜢	xmyx
蹮	xmzv
痚	xnbz
虈	xnck
藃	xncr
䒕	xncx
潇	xnd
㵿	xndb
㚠	xndh
鴵	xnen
㩋	xnfl
彇	xngl
髐	xngw
熇	xnhk
熽	xnhl
蟂	xnim
斆	xnjw
斅	xnjy
﨧	xnjz
啋	xnkm
嘐	xnkp
㗛	xnky
櫹	xnml
姣	xnn
睄	xnoo
暁	xnow
㬵	xnox
猇	xnq
㹲	xnqz
俲	xnrl
侾	xnrz
䌃	xnsd
䟁	xntg
毊	xnuk
㔅	xnvd
簘	xnvl
筿	xnvm
䉰	xnvx
効	xnwl
歊	xnwr
郩	xnxe
詨	xnyx
鷍	xnzn
䲒	xpan
奊	xpat
㾚	xpbe
㝍	xpby
藛	xpch
䕈	xpcm
躠	xpcr
䔑	xpcu
渫	xpd
脋	xpdo
觟	xpdt
㴽	xpdx
㩪	xpfb
缷	xpfe
㩦	xpfk
拹	xpfl
娎	xpfn
㨝	xpfo
鞵	xpgd
㢵	xpgk
鞢	xpgm
緳	xpgx
炨	xphb
爕	xphh
夑	xphw
灺	xphy
蝢	xpib
蠏	xpin
㣯	xpio
㣰	xpix
蟹	xpj
䥱	xpjh
䥾	xpjy
㔎	xpkd
㗨	xpkk
嗋	xpko
噧	xpky
䝱	xplb
韰	xplj
禼	xpls
榍	xpm
㭨	xpme
䦏	xpml
䊝	xpmx
㰔	xpmy
膎	xpod
䀘	xpok
䁋	xpom
旪	xpou
襭	xppb
䙊	xppj
祄	xppl
猲	xpqv
㒠	xprj
㰡	xprr
僁	xprx
絬	xpsk
垥	xptk
暬	xpto
屓	xpub
屟	xpum
䉏	xpvn
㱔	xpvx
齥	xpvy
瑎	xpwb
愶	xpxo
䚸	xpyl
臹	xqai
髤	xqam
苬	xqc
㳜	xqdm
㵻	xqdy
烌	xqhm
螑	xqiq
鏥	xqjb
鏅	xqjo
鎀	xqjp
㗜	xqkt
糔	xqmi
㹋	xqnp
䏫	xqo
䐰	xqoo
脙	xqoq
烋	xqrh
俢	xqrp
繍	xqsl
綇	xqsy
㱗	xqvq
璓	xqwn
褏	xqwy
齅	xqzq
鰚	xra
䲂	xrar
㾌	xrbe
䆭	xrbg
䳦	xrbn
䀏	xrbo
痃	xrbx
㝁	xrbz
蓒	xrcg
蔙	xrcr
藼	xrcx
蕿	xrcy
㓩	xrdd
䚭	xrdf
㳙	xrdo
䧎	xreo
揎	xrfa
㩊	xrfc
䗠	xrfi
㧦	xrfo
㧋	xrfq
䩙	xrgy
烜	xrhg
蠉	xriy
鍹	xrjg
鋗	xrjo
镟	xrjr
㔵	xrkb
吅	xrkk
㘣	xrko
梋	xrmo
㯀	xrmr
楥	xrmy
媗	xrng
嫙	xrnr
晅	xrog
暅	xroh
昍	xroo
矎	xrow
袨	xrpy
㹡	xrqy
繏	xrsb
縼	xrsr
䃠	xrur
㻹	xruy
箮	xrvg
䲻	xrwn
㦥	xrxx
怰	xrxy
谖	xry
䍻	xryb
讂	xryw
䠣	xrzb
胷	xsbo
哅	xskk
㚾	xsne
賯	xsoz
㐫	xswk
䱑	xtaj
䆝	xtbx
蒆	xtcn
䒸	xtcx
瀥	xtdk
岤	xteb
㞽	xtev
㿱	xtfy
嶨	xtje
雤	xtjf
燢	xtjh
鷽	xtjn
䬂	xtjv
㖸	xtka
㗾	xtkb
㕰	xtkm
樰	xtme
䦑	xtmg
桖	xtmx
㰒	xtmz
膤	xto
壆	xtpt
狘	xtqv
䋉	xts
坹	xttb
趐	xttx
䭥	xtul
辪	xtvu
㻡	xtwm
斈	xtwz
泶	xtxu
怴	xtxv
䤕	xtym
蹻	xtzk
鱮	xuab
䱬	xuao
疞	xubk
㽳	xuby
蒣	xuch
䔓	xucw
汿	xudl
滀	xudt
㷦	xueh
䧁	xuek
䦽	xuel
㞰	xuew
揟	xufo
魖	xugy
䅡	xuhb
虗	xuhq
烼	xuhu
蝑	xuio
㞊	xuiy
銊	xuja
鑐	xuje
㖅	xuka
喣	xukh
呴	xukk
㗵	xukr
槒	xumt
驉	xumy
姁	xunk
㜅	xunt
暊	xuob
朂	xuol
瞁	xuoq
鄦	xupe
䇓	xupl
䙒	xupt
裇	xupx
㑯	xurb
俆	xurh
㑔	xurr
侐	xurx
䋶	xusb
矞	xusk
㐨	xusl
﨏	xutk
盢	xutm
珬	xuwa
䘏	xuxe
㥠	xuxo
诩	xuy
䣴	xuye
䛙	xuym
䢕	xuza
魻	xxaj
鰕	xxay
䖎	xxej
夓	xxjw
呷	xxkl
㗇	xxky
閜	xxmk
梺	xxmx
騢	xxmy
㔠	xxol
祫	xxpk
敮	xxqy
傄	xxro
縖	xxsk
縀	xxsy
㙤	xxth
㽠	xxtr
赮	xxty
磍	xxuk
舺	xxvj
珨	xxwk
懗	xxxd
顨	xyal
鱏	xyau
䵫	xybh
㰬	xybr
荀	xyc
蘍	xycl
浔	xyd
奞	xydf
鄩	xyee
揗	xyfo
㢲	xygb
㽦	xyht
蟳	xyic
蟫	xyiu
㡄	xyjo
殾	xyly
桪	xymc
臐	xyoh
䞊	xyoo
賐	xyow
䙉	xypo
狥	xyqo
伨	xyrd
侚	xyro
坃	xyte
壦	xytf
燅	xyth
䭀	xyuu
璕	xywc
訙	xyyw
䛜	xyyx
䠝	xyzb
迿	xyzo
㾙	xbbj
䒖	xbcu
廞	xbgr
焮	xbhr
軐	xbiu
鈊	xbjx
噺	xbkj
噷	xbkr
嬜	xbln
㭢	xbmd
㭄	xbmu
㜦	xbnc
㛙	xbnu
脪	xboj
顖	xbpb
俽	xbrr
䅽	xbuh
惞	xbxr
䛨	xbyu
䜗	xbyx
䚱	xbyx
䒊	xibb
㿇	xibb
豀	xibd
㾷	xibj
㿽	xibm
瘜	xibx
䚫	xiby
蒵	xicd
䓇	xicd
莃	xicj
蒠	xicx
漝	xidb
凞	xidh
澙	xidh
㱤	xidj
滊	xidm
鸂	xidn
㶉	xidn
䲪	xidn
漇	xidr
觽	xidv
㲸	xidv
潝	xidx
㴧	xidx
㠄	xieb
㔒	xied
隟	xieg
隵	xieg
扱	xifj
䖒	xiha
稧	xihd
覤	xihe
戱	xihg
㸍	xihg
熺	xihk
䵱	xihk
熂	xihm
焟	xiho
㱆	xihr
黖	xihv
焬	xihw
螇	xiid
䖷	xiij
蠵	xiik
㣟	xiik
㕃	xiik
徆	xiix
舃	xijh
鑴	xijk
鈢	xijm
釳	xijq
釸	xijx
鎴	xijx
鏭	xijx
鉩	xijx
鉨	xijx
呬	xike
焁	xikh
唽	xikj
雟	xikk
㘊	xikk
㕧	xiku
噏	xikx
㗭	xikx
卥	xild
槢	ximb
騽	ximb
榽	ximd
騱	ximd
厀	xime
䮎	ximj
㯕	ximj
糦	ximk
驨	ximk
椞	ximm
椺	ximm
橀	ximm
晳	ximo
闟	ximx
惁	ximx
㮩	ximx
㭡	ximx
䳶	xind
㜎	xind
㛓	xinj
犔	xinm
㛫	xinw
嬆	xinx
睎	xiob
矖	xiob
䂀	xiod
瞦	xiok
䏩	xiok
䐅	xiou
盻	xiov
䁯	xiox
䫣	xipb
㐂	xiqq
忥	xiqx
㪧	xiry
繥	xisk
䢄	xism
縰	xisr
㽯	xitk
趘	xitm
㙾	xitz
磎	xiud
豯	xiud
㓾	xiud
磶	xiuh
囍	xiuk
礂	xiuk
䬣	xiuq
歖	xiur
欯	xiur
㰥	xiur
屖	xiuu
怸	xiux
䭒	xiux
䒁	xivb
䈪	xivl
琋	xiwj
㤸	xixd
怬	xixe
㦦	xixe
飁	xixi
虩	xixj
憘	xixk
恄	xixk
鵗	xixn
䙵	xixt
忚	xixy
謵	xiyb
霫	xiyb
䛊	xiyb
謑	xiyd
䨳	xiye
䛥	xiyj
霼	xiym
䀌	xiym
䜁	xiyt
衋	xiyx
諰	xiyx
鄎	xize
郋	xize
鮏	xkau
㝭	xkbu
䓷	xkci
涬	xkdg
㓑	xkdg
郉	xkge
蛵	xkig
㓝	xkjd
鋞	xkjg
銒	xkjg
娙	xkng
曐	xkou
睲	xkou
裄	xkpi
狌	xkqu
垶	xktu
䂔	xkug
䃏	xkuu
篂	xkvu
謃	xkyu
䜶	xlal
鱌	xlan
鮝	xlba
萫	xlco
䔗	xlcy
麘	xlgo
稥	xlho
衖	xlii
忀	xliy
䬕	xlji
銄	xljk
銗	xljk
鐌	xljn
䦳	xlme
䊑	xlmk
楿	xlmo
欀	xlmy
饟	xluy
亯	xlwo
㐮	xlwy
鄕	xlxe
鄊	xlxe
蠁	xlxi
蚃	xlxi
㗽	xlxk
䲗	xmai
豏	xman
䯭	xmay
㾾	xmbn
癎	xmbo
㿅	xmbr
甉	xmbw
苮	xmce
䕔	xmci
灦	xmdb
涀	xmde
䚚	xmde
鍌	xmdj
臽	xmdj
湺	xmdm
澖	xmdm
㳭	xmdm
㳄	xmdr
㵪	xmdr
瀗	xmdx
䧋	xmee
䧟	xmej
険	xmer
搟	xmfg
攕	xmfj
撊	xmfo
麙	xmgk
㢺	xmgn
䵇	xmgw
烍	xmhe
䆎	xmhj
㷿	xmhr
䄳	xmhv
蛝	xmig
䗾	xmih
衘	xmii
䘆	xmix
蚿	xmiy
鑦	xmjb
鋧	xmje
䥪	xmjh
铦	xmjk
鼸	xmjn
䤼	xmju
幰	xmjx
㡉	xmjy
䙹	xmke
嘕	xmkh
䝨	xmlb
㲔	xmlm
姭	xmln
毨	xmme
粯	xmme
麲	xmme
㭠	xmme
䦘	xmmg
㰊	xmmh
䊱	xmmj
枮	xmmk
糮	xmmm
㯗	xmmm
䦥	xmmm
橌	xmmo
㭹	xmmy
娊	xmne
奾	xmne
䢾	xmne
娨	xmng
㛾	xmnk
㪇	xmnw
娹	xmny
臔	xmob
睍	xmoe
䏹	xmoe
㬗	xmoh
尟	xmou
㫫	xmoy
㺤	xmqj
㺌	xmqn
尠	xmqu
仚	xmre
屳	xmre
佡	xmre
僴	xmro
僩	xmro
纎	xmsj
繊	xmsy
壏	xmtm
赻	xmtu
韯	xmuj
䃸	xmuj
䃱	xmuj
箲	xmve
䶟	xmvj
県	xmvx
䉳	xmvy
憸	xmxr
誢	xmye
䨘	xmye
諴	xmyk
醎	xmyk
譣	xmyr
誸	xmyy
䨷	xmyy
痟	xnbo
皢	xnbw
窙	xnbz
宯	xnbz
萷	xncd
䕧	xncx
䒝	xncx
䎄	xndx
撨	xnfh
髇	xngk
庨	xngz
灱	xnhd
灲	xnhd
焇	xnho
穘	xnhw
蟰	xnil
䬘	xnjk
䥵	xnjw
嘨	xnkl
呺	xnkv
㕺	xnkv
嘋	xnkw
䴛	xnlo
䊥	xnml
㮁	xnmo
婋	xnnj
㚣	xnnn
膮	xnow
獢	xnqk
㺒	xnqp
恷	xnrx
硣	xnuz
㪣	xnww
㲖	xnxm
揱	xnxu
憢	xnxw
㤊	xnxx
誵	xnyo
䨭	xnyo
訤	xnyx
謏	xnyy
誟	xnyz
踃	xnzo
冩	xpbh
䕵	xpcn
㓔	xpdc
㳦	xpdc
㴬	xpdc
䙽	xpde
㳿	xpdm
㴮	xpdo
㙰	xpdt
峫	xpee
嶰	xpen
㨙	xpfd
焎	xpfh
烲	xpfh
䩤	xpge
䩧	xpgk
燲	xphb
㸉	xphh
熁	xpho
炧	xphy
䵦	xphy
䡡	xpib
㕐	xpih
徢	xpir
㡜	xpjx
㖑	xpkc
㖿	xpke
䪥	xplj
卨	xplk
劦	xpll
䦖	xpmk
糏	xpmo
媟	xpnm
褉	xppd
䙎	xppd
龤	xprb
伳	xpru
綊	xpsr
塮	xptc
㙝	xpto
屧	xpum
㞕	xpuo
㐖	xpuv
翓	xpux
㞒	xpuz
䉣	xpvh
齘	xpvl
齛	xpvu
㽊	xpww
䙝	xpwy
恊	xpxl
㥟	xpxu
㦪	xpxy
讗	xpyk
齂	xpzn
鱃	xqai
鮴	xqam
㾋	xqbm
㱙	xqdv
峀	xqey
䡭	xqii
飍	xqji
銝	xqjm
樇	xqmo
褎	xqwy
翧	xrbx
蘐	xrcy
萲	xrcy
䚙	xrdg
㳬	xrdr
䩰	xrge
鞙	xrgo
贙	xrhb
蝖	xrig
蜁	xrir
颴	xrjr
鏇	xrjr
㔯	xrkk
駽	xrmo
檈	xrmy
䮄	xrmy
睻	xrog
䁢	xror
䝮	xroy
䁔	xroy
䍗	xrsy
塇	xrtg
琁	xrwr
愋	xrxy
諠	xryg
譞	xryy
敻	xsdw
䧺	xsuf
恟	xsxk
忷	xsxk
疦	xtbg
䆷	xtbk
疶	xtbu
㶅	xtdz
乴	xtfv
鞾	xtgl
轌	xtie
䫼	xtjg
觷	xtjy
吷	xtkg
辥	xtku
袕	xtpb
艝	xtve
鸴	xtxn
䎀	xtxv
䛎	xtyb
䨮	xtye
窢	xuba
欨	xubr
蕦	xucb
藇	xucb
藚	xucb
㵰	xudb
㰭	xudr
殈	xudx
潊	xudy
稰	xuho
歘	xuhr
歔	xuhr
稸	xuht
烅	xuhx
䳳	xuin
䬄	xuja
幁	xujb
楈	xumo
䦗	xumx
瞲	xuok
䏏	xuoy
盨	xupm
嬃	xupn
獝	xuqk
伵	xure
偦	xuro
続	xuse
縃	xuso
緖	xuso
䂆	xusu
㘧	xutl
壻	xuto
聟	xuue
沀	xuul
䈝	xuvo
㺷	xuwu
欰	xuxr
慉	xuxt
䎉	xuxu
䍱	xuyh
䣱	xuyk
訹	xuyu
譃	xuyy
㕛	xuyy
㜿	xuzl
丅	xxal
鶷	xxbn
疜	xxbx
谺	xxby
疨	xxby
蕸	xxcy
㰰	xxdr
溊	xxdy
陿	xxer
炠	xxhj
䖖	xxhj
烚	xxhk
虲	xxib
鏬	xxjh
鎼	xxju
鍜	xxjy
颬	xxjy
㘡	xxkj
㰨	xxkr
䪗	xxly
閕	xxmy
睱	xxoy
䘥	xxpj
㙈	xxtj
圷	xxtx
碬	xxuy
䫗	xxvb
筪	xxvj
笚	xxvj
舝	xxvl
㰺	xxvr
乤	xxxv
諕	xxyj
䛅	xxyj
䠍	xxzy
灥	xybu
蔒	xych
薫	xych
㵌	xydo
㨚	xyfo
燖	xyhc
爋	xyhl
稄	xyhw
䗼	xyih
䖲	xyio
鑂	xyjh
噚	xykc
㖊	xykc
嚑	xykh
樳	xymc
杊	xymi
毥	xymo
駨	xymo
㜄	xyni
矄	xyoh
䘩	xypo
偱	xyro
㒐	xyro
纁	xysh
紃	xysi
䋸	xyso
攳	xyuc
畃	xyuu
勲	xyvh
卂	xyvu
焄	xyyh
廵	xyzv
愻	xyzx
𥖄	xmur
𩐁	xpda
亜	yaaa
襾	yaal
㰳	yaar
䰲	yaav
窫	yabd
穵	yabv
痖	yaby
蕥	yacf
聐	yaek
崕	yaet
掗	yafa
挜	yafy
庌	yagy
稏	yaha
䄰	yahy
厑	yaib
厓	yait
錏	yaja
唖	yaka
吖	yakl
圔	yakm
䦪	yamv
枒	yamy
姶	yank
猚	yaqf
俹	yara
䃁	yaua
碣	yauv
㿿	yavm
瑘	yawe
孲	yaza
鮣	ybae
䜾	ybao
寅	ybb
癊	ybbs
蔩	ybcb
䓄	ybcj
䒡	ybcl
䓰	ybct
荶	ybcv
䕾	ybcw
蘟	ybcx
蒑	ybcy
殥	ybdb
滛	ybdf
洕	ybdo
濦	ybdx
訔	ybek
櫽	ybem
陻	ybet
阥	ybeu
㧢	ybfd
螾	ybib
䡛	ybii
輑	ybik
噖	ybkv
檭	ybmg
粌	ybml
猌	ybmq
闉	ybmt
憗	ybmx
婣	ybna
㸒	ybpr
㥯	ybpx
㹞	ybqj
乑	ybrn
飮	ybrr
絪	ybsd
䌥	ybsx
堙	ybt
韾	ybuo
磤	ybuy
璌	ybwb
㥼	ybxh
酳	ybyo
䆞	ycbb
㿑	ycbf
䆙	ycbv
窔	ycbx
宎	ycby
䔄	yccf
蓔	ycch
苭	yccl
薬	yccm
葽	yccn
蘨	yccx
隃	yced
㟱	yceh
岆	ycey
㨱	ycfk
㫏	ycfn
摿	ycfo
徺	yciw
鎐	ycjf
嗂	yckf
喓	yckn
柼	ycmb
榣	ycmf
枖	ycmy
婹	ycnn
㹓	ycnw
㫐	ycob
覞	ycoe
曣	ycoh
眑	ycol
䁏	ycon
颻	ycpi
袎	ycpl
祅	ycpy
猺	ycq
獟	ycqw
㑸	ycrk
偠	ycrn
倄	ycro
仸	ycry
䌊	ycsf
纅	ycsm
䌁	ycsn
䋂	ycsx
㙘	yct
顤	yctb
尭	ycuw
䶧	ycvw
爻	ycx
殽	ycxy
詏	ycyl
鴢	ycyn
䚺	ycyw
䢣	yczk
鼼	yczl
䲜	yeaa
䱒	yeab
皣	yebl
䓉	yece
洂	yedd
㪑	yedy
嶪	yeew
掖	yef
捙	yefi
擛	yefm
擫	yefq
擨	yefr
抴	yefu
㥷	yegx
擪	yeiu
蠮	yeix
㡋	yejd
䥟	yejv
㖡	yekn
嚈	yekq
㗼	yekw
䁆	yeod
瞱	yeol
瞸	yeom
暍	yeov
曗	yeow
歋	yepr
倻	yer
偞	yerm
墷	yetl
㙒	yett
堨	yetv
餣	yeud
䭇	yeuk
礏	yeuw
䈎	yevm
鵺	yewn
亪	yewv
曵	yeyd
鄓	yeze
䢡	yezm
鰑	yhaw
䱀	yhay
羊	yhb
奍	yhbl
殃	yhd
㦹	yhdg
䬗	yhdi
瀁	yhdl
漾	yhdn
昜	yhdw
崸	yheb
阦	yheh
崵	yhew
岟	yhey
攁	yhfl
䵮	yhhw
蛘	yhi
䖹	yhil
輰	yhiw
颺	yhjw
鉠	yhjy
姎	yhny
䑆	yhol
䁑	yhow
眏	yhoy
卬	yhp
禓	yhpw
氜	yhqo
氱	yhqw
䭐	yhux
䬺	yhuy
羏	yhyp
䱌	yial
鮨	yiao
鯣	yiaw
鮧	yiay
宜	yib
䣡	yibe
肄	yibl
兿	yibs
荑	yic
䔬	yicb
苢	yick
䓹	yicl
虉	yicn
萓	yicq
萟	yicw
义	yid
浂	yidt
澺	yidx
顗	yieb
陭	yiek
耴	yiev
嶬	yiew
峓	yiey
焲	yihn
轶	yii
輢	yiik
垼	yiit
蛡	yiix
圛	yikg
黳	yikh
䗟	yiki
嫛	yikn
瞖	yiko
㙠	yikt
㼢	yikw
意	yil
椬	yimq
檍	yimx
嬄	yina
㛕	yinb
鶃	yine
㚤	yiny
曀	yioa
曎	yiog
膉	yiom
鶍	yion
肊	yiov
晹	yiow
禕	yipl
襼	yips
袣	yipu
衪	yipy
狋	yiqx
佚	yir
俋	yirb
㑥	yirw
仪	yirx
睪	yisg
瓵	yisw
繶	yisx
鷧	yiun
㰻	yiur
礒	yiuw
頉	yivb
艗	yivm
㺿	yiwl
悥	yiwx
刈	yix
㦉	yixa
醳	yiyg
鹥	yiyn
劓	yiz
辷	yiza
迻	yizx
䲓	yjar
䫡	yjbb
萒	yjce
䓂	yjck
蔅	yjcn
奄	yjdv
嵓	yjek
豓	yjem
隒	yjen
嵃	yjep
巘	yjeq
巗	yjew
嶖	yjex
掩	yjf
揜	yjfc
抁	yjfe
麣	yjgw
焰	yjh
黫	yjht
䗎	yjit
郾	yjk
円	yjka
㘖	yjkb
㿼	yjkm
匽	yjkn
㗴	yjko
噞	yjkr
㘙	yjkw
椻	yjmn
験	yjmr
㮒	yjmt
㸶	yjnd
酀	yjne
㬫	yjno
臙	yjoh
曕	yjok
猒	yjoq
昖	yjos
䀽	yjov
曮	yjow
㦔	yjox
暥	yjoy
覎	yjoz
裺	yjpd
艶	yjqb
顩	yjrb
偣	yjro
偐	yjrp
䌪	yjsj
壧	yjtw
䊙	yjum
躽	yjun
齴	yjvp
琂	yjwk
㤿	yjxd
厳	yjxw
遃	yjzp
鱦	ykaa
㿘	ykbk
䚆	ykce
萾	ykcm
潆	ykd
灐	ykdj
浧	ykdw
巆	ykek
巊	yken
摬	ykfe
攍	ykff
㨕	ykfm
䧹	ykgf
譍	ykgk
廮	ykgn
応	ykgx
㢍	ykgy
䵴	ykha
罃	ykhf
嫈	ykhn
甇	ykhw
蠳	ykin
锳	ykj
䤝	ykje
郢	ykk
啨	ykko
嘤	ykky
鷪	ykmh
梬	ykmv
䊔	ykmy
孆	yknn
賏	ykob
䑉	ykof
䀴	ykog
鑍	ykoj
譻	ykok
膡	ykoo
䙬	ykpn
㹵	ykqg
僌	ykrw
偀	ykry
䃷	ykuf
軈	ykux
碤	ykuy
孾	ykzn
唷	yok
魭	yrae
䱲	yrau
䅈	yrbh
鹓	yrbn
宛	yrbv
葾	yrcx
薗	yrcy
薳	yrcz
㤪	yrdx
䲮	yren
㟶	yrex
掾	yrf
弲	yrgo
螈	yri
蜵	yria
䖠	yrif
衏	yrii
䡝	yriv
鈨	yrje
鋺	yrjv
圎	yrkb
剈	yrkd
鶰	yrkn
肙	yrko
榞	yrmx
榬	yrmy
盶	yro
裫	yrpa
䦾	yrpe
鶢	yrpn
獂	yrqx
㐾	yrr
䨊	yrra
傆	yrrx
貟	yrsb
縁	yrsn
贠	yrsr
鼘	yrul
䳣	yrun
䬼	yruo
㠾	yrxj
夗	yrxv
㥳	yrxx
䛄	yryv
鰫	ysak
鱅	ysal
癕	ysbf
㴩	ysdb
㴄	ysdk
滽	ysdl
慂	ysdx
㟾	ysel
㞲	ysev
廱	ysgf
鷛	ysgn
㷏	yshh
禜	yshx
噰	yskf
柡	ysmu
㜉	ysnb
嫞	ysnl
牅	yspl
傛	ysrk
㦷	yssg
勈	yssl
㙲	ystf
塎	ystk
䞻	ystl
雝	ysvf
䗸	yswi
㐯	yswo
怺	ysxy
䖃	ytc
蘥	ytcc
岄	yteo
彠	ytey
捳	ytfe
抈	ytfo
蚎	ytio
軏	ytiw
䥃	ytjf
䤦	ytjg
㰛	ytmm
㹊	ytnf
㜰	ytnm
嬳	ytny
㬦	ytoy
粤	ytp
鸑	ytqn
鸙	ytrn
䋐	ytsv
䟑	yttc
趯	yttf
箹	ytvu
篗	ytvy
恱	ytxe
䟠	ytzv
䢲	ytzy
鮽	yuah
彧	yuak
魣	yual
亐	yuav
䰻	yuaw
鰅	yuay
窬	yub
䔡	yuca
蒮	yucf
芌	yuck
茰	yucn
䖇	yucp
蘌	yucx
澞	yudt
㠘	yueb
嶎	yuec
旟	yufb
乻	yufv
魊	yuga
㼌	yugg
麌	yugt
燠	yuh
稢	yuha
鸆	yuhn
䲣	yuhw
蝓	yui
輍	yuik
蜟	yuio
鐭	yujd
錥	yujo
䍞	yuka
喅	yukl
噳	yukt
栯	yumo
楡	yumv
媀	yuny
䐳	yuoa
睮	yuod
䏸	yuok
䁌	yuoo
㬰	yuor
祤	yupx
衧	yupy
儥	yurb
㒁	yurg
伃	yurl
伛	yurq
歈	yurr
㑨	yuru
㼶	yurw
偊	yury
豫	yus
纡	yus
罭	yusa
圫	yutq
馀	yuu
軉	yuub
饇	yuuk
䈅	yuva
玙	yuw
袬	yuwn
惐	yuxa
䣁	yuxe
㥔	yuxo
逾	yuz
䢩	yuzw
蒷	yycb
菀	yycv
阭	yyee
耺	yyes
㩈	yyfk
抎	yyfs
䩵	yygi
鞰	yygm
熉	yyhb
鈗	yyje
呍	yyks
馻	yyme
枟	yyms
㜏	yynb
㛣	yynr
㚺	yynz
腪	yyoi
眃	yyos
褞	yypm
傊	yyrb
伝	yyrs
縜	yysb
䞫	yytk
㚃	yyua
䇖	yyvp
贇	yywb
鄾	yzae
䱂	yzal
㱊	yzar
莸	yzc
羐	yzcj
泑	yzdl
滺	yzdx
聈	yzel
峟	yzeo
峳	yzew
庮	yzgy
䅎	yzhn
蚰	yzi
蜏	yzin
鼬	yzj
䥳	yzjw
唀	yzkn
嚘	yzkw
㘥	yzkx
櫾	yzmx
姷	yzno
牰	yzny
肬	yzo
脜	yzoz
牗	yzpl
㺠	yzqg
㛜	yzrn
㐛	yzrv
偤	yzry
糿	yzsd
纋	yzsw
䳑	yzun
貁	yzvb
㰶	yzwr
懮	yzxw
酭	yzyo
逌	yzza
㝞	yaba
㾎	yaba
䆘	yabj
㳌	yadj
漄	yadt
㧎	yafy
庘	yagj
齾	yahr
䅉	yahy
圧	yait
厊	yaiy
鐚	yajx
铔	yajy
劜	yalv
犽	yaqy
圠	yatv
䝟	yavd
齖	yavy
笌	yavy
䪵	yayb
䢝	yaza
㝙	ybbb
瘖	ybbo
㪦	ybbw
苂	ybch
䕃	ybcs
濥	ybdb
峾	ybde
㴈	ybde
泿	ybdg
凐	ybdt
垽	ybdt
冘	ybdv
湚	ybdv
㶏	ybdx
崯	ybej
檃	ybem
㞤	yber
嶾	ybex
隠	ybex
㧈	ybfg
鞇	ybgd
䴦	ybgk
靷	ybgl
秵	ybhd
䖜	ybhy
㣧	ybiv
㕂	ybiv
斦	ybjj
䖐	ybjj
鈏	ybjl
鈝	ybjn
淾	ybju
㡥	ybjx
唫	ybkj
圁	ybkk
噾	ybko
囙	ybkv
㖗	ybkv
䪩	yblv
栶	ybmd
誾	ybmk
㙬	ybmt
檼	ybmx
裀	ybpd
䄄	ybpd
犾	ybqq
㹜	ybqq
㐺	ybrr
㱃	ybrr
侌	ybrs
㒚	ybrx
緸	ybst
趛	ybtj
赺	ybtv
朄	ybuj
碒	ybuj
筃	ybvd
䇙	ybvl
鷣	ybxn
垔	ybxt
懚	ybxx
㦩	ybxx
䤃	ybyo
䚿	ybyr
諲	ybyt
訡	ybyv
霠	ybyv
霒	ybyv
讔	ybyx
䨸	ybyx
䆗	ycbl
㝔	ycbx
穾	ycby
㵸	ycdc
溔	ycdh
㴭	ycdo
殀	ycdy
嶤	ycew
揺	ycfg
抭	ycfj
䯚	ycgo
㢓	ycgu
䴠	ycgy
烑	ychd
熎	ychf
䖴	ycid
䬙	ycjf
鷕	yckn
㔽	yclk
榚	ycmh
楆	ycmn
闄	ycmn
騕	ycmn
㿢	ycob
暚	ycof
矅	ycof
䁘	ycof
䚻	ycpk
䙅	ycpn
飖	ycpx
䌛	ycpx
狕	ycql
傜	ycrf
㑾	ycrk
餆	ycud
磘	ycuf
䂚	ycux
筄	ycvd
艞	ycvd
齩	ycvx
愮	ycxf
䳩	ycxn
㞁	ycyb
讑	ycyc
謡	ycyf
鴁	ycyn
䛂	ycyu
訞	ycyy
䠛	yczf
潱	yeda
殗	yedd
漜	yedt
澲	yedw
㱌	yeer
嶫	yeew
䧨	yeew
捓	yefe
㩎	yefq
䤶	yejd
鎁	yeje
鎑	yejm
鍱	yejm
䥡	yejm
鐷	yejm
䤳	yejn
䥺	yejy
釾	yejy
䎨	yeld
䊦	yema
壄	yemt
驜	yemw
曅	yeol
㸣	yepw
僷	yerm
枼	yeum
枽	yeum
䭎	yeum
䭟	yeum
亱	yewd
鸈	yeyn
㱉	yeyr
㔦	yhbl
㟅	yhee
抰	yhfy
㨾	yhfy
炴	yhhy
軮	yhiy
鍚	yhjw
鐊	yhjw
鍈	yhjy
鸉	yhmn
様	yhmu
楧	yhmy
柍	yhmy
駚	yhmy
暘	yhow
眻	yhoy
胦	yhoy
㬕	yhoy
㺊	yhqx
㒕	yhrf
傟	yhrx
佒	yhry
紻	yhsy
坱	yhty
礢	yhul
珜	yhwy
懩	yhxl
慃	yhxx
䒋	yhyb
羪	yhyl
劷	yhyl
鴹	yhyn
霷	yhyw
諹	yhyw
䍩	yhyw
詇	yhyy
雵	yhyy
㿮	yhyy
䲑	yiaw
䰙	yiay
宐	yiba
㝣	yibd
㝖	yibd
羛	yibf
㾨	yibk
寱	yibm
䆿	yibm
䴊	yibn
冝	yibq
寲	yibr
痬	yibw
㽈	yibw
瘱	yibx
匇	yibx
觺	yiby
䓃	yicb
苅	yicd
䔱	yice
䕍	yick
蓺	yicw
蘙	yicx
䖁	yicx
䔟	yicx
藙	yicy
芅	yicy
䒾	yicy
䓈	yicy
瀷	yidb
䫑	yidb
㴒	yidc
湙	yidd
㶠	yidg
㴁	yidj
㵝	yidk
㱞	yidl
㵩	yidm
㱲	yidm
㳑	yidm
殔	yidn
浳	yido
泆	yidu
沶	yidx
㲼	yidx
㳖	yidy
彛	yiec
阣	yieq
䧧	yiew
㠖	yiew
崺	yiey
䧇	yiey
䧅	yiey
撎	yifa
旑	yifk
㫊	yifk
㢞	yigb
䰯	yigr
靾	yigu
弬	yigv
䯆	yigv
庡	yigy
骮	yigy
䩟	yigy
㡼	yigy
穓	yihb
熼	yihb
䖌	yihd
燡	yihg
䭲	yihk
稦	yihl
熤	yihl
䵝	yihv
秇	yihw
燱	yihx
熪	yihx
炈	yihy
黓	yihy
䄿	yihy
䄬	yihy
䄩	yihy
㦾	yihy
螔	yiij
䗑	yiil
轙	yiiw
䗷	yiix
蛜	yiiy
蛦	yiiy
㕈	yiiy
鏔	yijb
䬁	yijb
帠	yijj
鶂	yijn
鉯	yijr
幆	yijv
鈠	yijy
鈘	yijy
釴	yijy
贀	yikb
唈	yikb
㔴	yikb
㘁	yikg
媐	yikn
欭	yikr
㘈	yikr
巸	yiks
呹	yiku
呭	yiku
䃜	yiku
悘	yikx
瑿	yiky
殹	yiky
㖂	yiky
頥	yilb
郼	yile
鷾	yiln
豙	yiln
竩	yilq
䪰	yilx
㰘	yimc
䦴	yimg
駅	yimi
檹	yimk
榏	yimm
棭	yimn
栺	yimo
枻	yimu
䭿	yimu
檥	yimw
槸	yimw
栘	yimx
柂	yimy
栧	yimy
桋	yimy
䮊	yimy
杝	yimy
䴬	yimy
㜒	yinc
㚦	yinl
㜋	yinm
妷	yinu
鳦	yinv
鸃	yinw
嬟	yinw
嬑	yinx
㛄	yiny
䞅	yiok
暆	yioy
敡	yioy
貤	yioy
䝯	yioy
顊	yipb
乊	yipb
裿	yipk
䘸	yipn
衵	yipo
䄁	yipu
褹	yipw
袘	yipy
㐌	yipy
䘝	yipy
獈	yiqm
㹭	yiqy
㹫	yiqy
伿	yirb
㑜	yirj
㐹	yirq
㥋	yirx
伇	yiry
侇	yiry
偯	yiry
歝	yisr
㰝	yisr
䋵	yisv
斁	yisw
攺	yisw
䋚	yisx
䌻	yisx
㙪	yita
墿	yitg
㙯	yits
埶	yitw
畩	yity
坄	yity
饐	yiua
豷	yiua
壱	yiub
䭂	yiub
䭞	yiug
夁	yiuk
劮	yiul
䬮	yiur
㱅	yiur
亄	yiuv
㞔	yiux
䢃	yiux
㦤	yiux
敼	yiuy
豛	yiuy
䇼	yivb
䉗	yive
䇵	yivj
㣇	yivj
齮	yivk
䝝	yivk
齸	yivm
貖	yivm
籎	yivr
笖	yivr
䉝	yivw
䝘	yivy
䉨	yivy
䇩	yivy
箷	yivy
帟	yiwj
㛳	yiwn
玴	yiwu
䖊	yixj
㥴	yixj
忔	yixq
怈	yixu
㣻	yixx
恞	yixy
䎈	yixy
弌	yiya
讉	yiyb
霬	yiyb
誃	yiyd
謻	yiyd
隿	yiyf
訳	yiyi
䬥	yiyl
詍	yiyu
訲	yiyv
䚷	yiyv
㡫	yiyv
翳	yiyx
繄	yiyx
譩	yiyx
醷	yiyx
羠	yiyy
䣧	yiyy
㓷	yizd
逘	yizu
跇	yizu
跠	yizy
鰋	yjan
㿕	yjbj
㕣	yjbk
鴳	yjbn
㝚	yjbv
葕	yjci
莚	yjcv
灔	yjdb
剦	yjdd
渷	yjde
䣍	yjde
扊	yjdh
觾	yjdh
㶄	yjdj
灎	yjdm
㳂	yjds
溎	yjdt
夵	yjdx
隁	yjen
巚	yjeq
巌	yjew
㫃	yjfr
㢂	yjgk
㢛	yjgr
黭	yjhc
黤	yjhd
熖	yjhj
爓	yjhj
黬	yjhk
䖗	yjhk
鬳	yjhl
焔	yjho
䅧	yjho
㷔	yjho
敥	yjhy
䗡	yjih
㷳	yjih
檿	yjim
鳫	yjin
嬮	yjin
䤷	yjjn
嵒	yjke
鶠	yjkn
喭	yjkp
㰽	yjkr
㖶	yjkt
碞	yjku
䍾	yjkx
䎦	yjlh
龑	yjlt
乵	yjlv
㭺	yjmd
驠	yjmh
樮	yjmh
椼	yjmi
櫩	yjmj
䦲	yjmk
騴	yjmn
楌	yjmp
欕	yjmw
梴	yjmz
㛪	yjnd
姸	yjng
㚧	yjng
㷼	yjnh
娮	yjnk
牪	yjnn
嬊	yjnn
姲	yjnn
娫	yjnv
孍	yjnw
㫟	yjok
妟	yjon
鷃	yjon
䳛	yjon
䞁	yjon
䑍	yjon
䁙	yjoy
䄋	yjpd
褗	yjpn
㺂	yjqk
狿	yjqv
䨄	yjrf
傿	yjrh
䳺	yjrn
䳡	yjrn
酓	yjry
綖	yjsv
壛	yjtj
塩	yjtm
䞛	yjtm
䀋	yjtm
硽	yjud
䂩	yjud
軅	yjuf
硏	yjug
䂴	yjuk
揅	yjuu
礹	yjuw
齞	yjvb
篶	yjvh
䇾	yjvk
䶫	yjvw
䉷	yjvw
珚	yjwd
愝	yjxn
䛳	yjyd
詽	yjyg
䜩	yjyh
訮	yjyk
醶	yjyr
郔	yjze
䗺	yjzi
䢥	yjzo
䢭	yjzr
颕	ykbr
䣐	ykce
䕦	ykcf
藀	ykch
㲟	ykcm
蘡	ykcn
鶧	ykcn
灜	ykdf
濙	ykdh
㶈	ykdi
瀯	ykdk
濚	ykdm
溋	ykdm
㵬	ykdm
瀴	ykdn
濴	ykdu
渶	ykdy
鞕	ykgg
噟	ykgk
覮	ykhe
謍	ykhk
鶑	ykhn
䪯	ykho
䁝	ykho
煐	ykhy
褮	ykhy
蝿	ykid
蝧	ykiy
鐛	ykjx
㡕	ykjy
韺	ykly
櫿	ykmk
䦫	ykmy
㹚	yknk
盁	yknm
暎	ykoy
朠	ykoy
䁐	ykoy
㑞	ykrc
绬	yksy
䤰	yktj
䭗	ykue
礯	ykux
䭘	ykux
矨	ykuy
䭊	ykuy
䬬	ykuy
籯	ykvf
籝	ykvf
珱	ykwn
蛍	ykxi
営	ykxk
愥	ykxy
䨍	ykyj
霙	ykyy
寃	yrbd
䬇	yrbi
㾓	yrbo
惌	yrbx
蒬	yrcd
蒝	yrcx
渕	yrdd
渆	yrdd
灁	yrdu
渁	yrdu
鼝	yrdy
溒	yrdy
邧	yree
䩩	yrgv
蚖	yrie
蝝	yriu
厡	yriu
厵	yrix
蝯	yriy
䥉	yrjd
鎱	yrjy
囦	yrku
噮	yrky
棩	yrma
杬	yrme
㭇	yrme
騵	yrmx
嬽	yrnd
㹉	yrnx
媴	yrny
禐	yrpy
褤	yrpy
褑	yrpy
猨	yrqy
㥐	yrrx
䏍	yrso
䬧	yrue
䳒	yrun
笎	yrve
駌	yrxm
妴	yrxn
悁	yrxo
酛	yrye
䛇	yryk
謜	yryx
邍	yrzu
逺	yrzy
㝘	ysbk
彮	ysbp
苚	yscy
灉	ysdf
嵱	ysek
䧡	ysel
揘	ysfw
醟	yshy
䗤	ysil
銿	ysjy
嗈	yskb
槦	ysml
硧	ysuy
砽	ysuy
㽫	yswt
㻾	yswy
郺	ysxb
愹	ysxk
愑	ysxl
悀	ysxy
惥	ysyx
䆕	ytbg
䆢	ytbg
泧	ytdv
䋤	ytfu
戉	ytgv
黦	ythv
䡇	ytie
蚏	ytio
䢁	ytio
曱	ytll
枂	ytmo
㜧	ytnr
禴	ytpc
礿	ytpu
䶳	ytrj
矱	ytuy
籰	ytvy
籆	ytvy
䠯	ytzc
跀	ytzo
鯲	yuad
䜽	yuad
鱊	yuak
鷠	yuan
䤋	yuba
寙	yubg
螸	yubi
䆰	yubk
鴪	yubn
鴧	yubn
䴁	yubn
㲾	yubu
穻	yuby
㝢	yuby
萮	yucd
蕍	yucd
蓹	yuce
蘛	yuco
荢	yucy
茟	yucy
萭	yucy
淢	yuda
㚜	yuda
㶛	yudb
盓	yudm
灪	yudp
㳚	yudu
湡	yudy
㳛	yudy
㠨	yuec
陓	yuek
㧒	yufb
扵	yufd
挧	yufx
扜	yufy
䍂	yufy
㣃	yugg
䩽	yugk
㰲	yugr
骬	yugy
䩒	yugy
㡰	yugy
穥	yuhb
䵥	yuhb
稶	yuhd
焴	yuho
爩	yuhp
䱷	yuhw
秗	yuhy
䄨	yuhy
㷒	yuhy
䗨	yuia
䘘	yuii
虶	yuiy
䬔	yujd
䥏	yuje
轝	yuji
鋊	yujk
鸒	yujn
䫻	yujo
礜	yuju
㦛	yujx
釪	yujy
銉	yujy
鍝	yujy
唹	yukd
匬	yukd
喐	yuke
噊	yukk
喩	yukv
㔱	yuky
䮙	yuma
欝	yumc
欎	yumc
棜	yumd
騟	yumd
驈	yumk
櫲	yumn
棛	yumo
鬰	yump
杅	yumy
楀	yumy
楰	yumy
嬩	yunb
娯	yunb
鴥	yunb
㚥	yuny
䁩	yuoa
㬂	yuoy
牏	yupd
䘻	yupo
䄏	yupy
㺞	yuqb
㒜	yurb
龥	yurb
雓	yurf
俼	yuro
兪	yurv
緎	yusa
繘	yusk
䂊	yusn
䋭	yuso
䋖	yusy
㽣	yuta
堬	yutd
畭	yuth
堣	yuty
䞝	yuty
戫	yuua
礖	yuub
礇	yuud
䃋	yuud
硢	yuuh
䂛	yuul
㦽	yuuv
砡	yuuy
籅	yuvb
箊	yuvd
貐	yuvd
䉛	yuvd
篽	yuve
籞	yuvx
歶	yuvy
琙	yuwa
㺮	yuwk
鳿	yuwn
玗	yuwy
斔	yuwy
懙	yuxb
頨	yuxb
忬	yuxl
㤢	yuxo
㥥	yuxy
㥚	yuxy
羭	yuyd
霱	yuyk
醧	yuyk
謣	yuyk
䣿	yuym
㙑	yuyt
斞	yuyu
䜡	yuyw
㪀	yuyw
䨒	yuyx
酑	yuyy
䨞	yuyy
㝼	yuyy
踰	yuzd
迃	yuzk
逳	yuzo
䢓	yuzy
䢖	yuzy
䆬	yybb
荺	yycd
蒀	yycm
蒕	yycm
奫	yyda
夽	yyds
澐	yyds
䢵	yyee
㟦	yyei
䲰	yyen
抣	yyfd
熅	yyhm
秐	yyhs
蝹	yyim
䤞	yyjy
䚋	yyke
喗	yyki
囩	yyks
韗	yyli
橒	yyms
賱	yyoi
緷	yysi
繧	yyss
畇	yytd
磒	yyub
餫	yyui
㞌	yyuz
篔	yyvb
齳	yyvi
齫	yyvm
䉙	yyvs
玧	yywe
愪	yyxb
頵	yyyb
霣	yyyb
䪳	yyyb
䨶	yyyv
丣	yzaa
䆜	yzbo
㾞	yzby
䒴	yzco
苃	yzcy
莤	yzcy
蒏	yzcy
湵	yzdj
㴗	yzdn
瀀	yzdw
㳊	yzdw
沋	yzdy
㳺	yzdz
㫍	yzfw
斿	yzfz
㶭	yzhl
秞	yzhy
䖻	yziv
輶	yziy
輏	yziy
䬀	yzjl
哊	yzko
㗀	yzky
㕱	yzky
䚃	yzle
㮋	yzme
櫌	yzmw
楢	yzmy
梄	yzmy
駀	yzmy
㚭	yzny
䍃	yzpf
禉	yzpy
狖	yzqb
㹨	yzqy
㒡	yzrx
䞥	yzto
䀁	yzum
怣	yzux
䑻	yzvz
亴	yzwj
㤑	yzxk
怮	yzxl
怞	yzxy
㓜	yzyd
䛻	yzyo
㕗	yzys
㽕	yzyv
㐕	yzyv
訧	yzyy
孧	yzyz
迶	yzzo
䢟	yzzw
邎	yzzx
逰	yzzz
䢊	yzzz
𡛟	ytnv
帀	zaaj
䕹	zac
沞	zadj
拶	zaf
雑	zajf
鉔	zajj
囋	zakb
囐	zakq
桚	zamx
臢	zaob
䨿	zatf
磼	zaum
㦫	zaxb
㞉	zayg
栆	zcad
䲃	zcag
皁	zcbu
薻	zccg
䗢	zcik
䖣	zciv
䥣	zcjj
㡟	zcjo
喿	zckm
唕	zcku
㯾	zcmo
梍	zcmq
傮	zcro
艁	zcvk
璅	zcwg
醩	zcyo
菑	zdct
扗	zdft
睵	zdok
傤	zdri
縡	zdsu
酨	zduy
䣬	zdyg
䰹	zea
皟	zebb
蔶	zec
䕉	zecg
㳻	zedo
汄	zedr
滜	zedu
溭	zedw
㟙	zee
崱	zeed
択	zefi
捑	zefo
䯔	zegq
庂	zegr
稄	zeh
㣱	zeib
赜	zeir
㖽	zekb
唶	zeko
樍	zem
嫧	zen
昗	zeob
襗	zep
㺓	zeqb
睪	zesg
鸅	zesn
矠	zeso
歵	zevb
齰	zevo
諎	zeyo
囎	zfk
㻸	zfwy
鬵	zgal
鱛	zgao
甑	zgb
熷	zgho
橧	zgmo
䙢	zgpo
増	zgto
璔	zgwo
譄	zgyo
塟	zhct
㘸	zhdt
羘	zhiy
匨	zhku
㮜	zhmu
賘	zhod
臓	zhoi
羘	zhoy
弉	zhpc
銺	zhvj
剚	ziad
鰦	ziay
䰵	ziaz
㾅	zibp
茊	zicq
葘	zict
䔂	zicu
蓻	zicw
芓	zicz
澬	zidb
崰	ziet
䦻	ziez
䆅	zihb
䅆	zihr
䅔	ziht
稵	zihy
秄	zihz
釨	zijz
唨	zikq
䎩	zilt
椔	zimt
橴	zimx
牸	zinz
胏	ziop
䐉	ziot
禌	zipy
倳	zirl
㑑	zirz
紎	zisq
趦	zitk
赼	zitr
㽧	zity
嗭	ziub
胾	ziur
䣎	zive
鈭	zivj
姕	zivn
㿳	zivt
㜽	zivz
璾	ziwa
齍	ziwm
㺭	ziwz
谘	ziy
孖	zizz
兂	zja
㔆	zjad
㟛	zjeg
攅	zjfb
鄼	zjfe
㣅	zjgy
䭕	zjil
蹔	zjir
鐟	zjjo
囋	zjkb
酂	zjn
㜺	zjnb
䐶	zjo
襸	zjpb
儧	zjrb
饡	zjub
瓉	zjwb
赞	zjx
䔘	zocq
蓙	zoct
莋	zocv
㵶	zodf
鈼	zojv
㘀	zokm
䎰	zolj
㭮	zomd
椊	zomu
㸲	zon
袏	zopg
㤰	zorx
繓	zos
㘴	zotr
飵	zouv
筰	zovv
㝾	zoyg
䟶	zozt
䰖	zra
繤	zrcx
揝	zrfo
㸇	zrhb
䡽	zrib
纉	zrsb
䌣	zrsk
籫	zrvb
篹	zrvv
劗	zrxd
䰌	zsar
葼	zsc
蓗	zscr
嵕	zse
嵸	zser
嵏	zsew
㨑	zsfw
搃	zsfx
熜	zshx
䗥	zsir
蝬	zsiw
鍐	zsjw
椶	zsmw
惣	zsnx
昮	zsol
朡	zsow
䙕	zsp
猔	zsq
猣	zsqw
緵	zssw
㙡	zstr
堫	zstw
磫	zsur
䈦	zsvw
惾	zsxw
愡	zsxx
蒩	zucq
䚝	zudu
靻	zugq
䖕	zuhq
鎺	zujq
哫	zukr
傶	zurx
㰵	zuwr
爼	zuxq
㝡	zvby
嶵	zvef
稡	zvhu
穝	zvhy
枠	zvmu
檇	zvmv
樶	zvmy
晬	zvo
祽	zvpu
絊	zvsb
纗	zvsk
㭰	zvvn
䘒	zvxw
辠	zvzu
鰂	zwad
鱡	zwau
戝	zwkg
蠈	zwki
䔿	zycc
捘	zyfw
銌	zyjz
繜	zysc
譐	zyyc
鯐	zzar
菆	zzcy
㔌	zzed
棸	zzem
掫	zzfy
黀	zzgy
媰	zznp
緅	zzsy
赱	zztn
齺	zzvp
箃	zzvy
㻓	zzw
䠫	zzzn
魳	zaaj
韴	zalj
雥	zarf
䞙	zatj
䪞	zatj
沯	zauu
竃	zcbd
㷮	zcho
趮	zctm
䜊	zcyo
蹧	zczo
渽	zddk
溨	zddm
洅	zddr
㱰	zddu
䏁	zdeu
䮨	zdmu
賳	zdok
儎	zdri
烖	zduh
䵧	zduh
夨	zean
䕪	zecg
㳁	zedr
泎	zedv
蠌	zeig
耫	zelb
瞔	zeob
伬	zeri
礋	zeug
䶦	zevb
齚	zevv
䇥	zevv
謮	zeyb
譛	zfyo
䰝	zgao
㽪	zgto
磳	zguo
孶	zicz
茡	zicz
㱴	zidb
秶	zidh
栥	zidm
㰷	zidr
湽	zidt
㞨	ziez
㧗	zifb
輺	ziit
鍿	zijt
吇	zikz
榟	zimu
杍	zimz
姉	zinl
頿	zipb
頾	zipb
䘣	zipb
矷	ziuz
䖪	zivi
㠿	zivj
啙	zivk
呰	zivk
鶅	zivn
胔	zivr
㰣	zivr
㧘	zivu
訿	ziyb
灒	zjdb
濽	zjdb
撍	zjfy
鐕	zjjy
酇	zjne
禶	zjpb
㳫	zjuj
䬤	zjul
簮	zjvo
讃	zjyb
䍼	zjyy
葃	zocv
葄	zocv
岝	zoev
稓	zoho
秨	zohv
糳	zojm
䝫	zoov
侳	zort
㑅	zoru
䋏	zosv
䞰	zotd
䞢	zotv
鑚	zrjb
䤸	zrju
䂎	zrsb
鯼	zsaw
鬉	zsaw
鯮	zsax
瘲	zsbr
揔	zsfx
摠	zsfx
捴	zsfx
㢔	zsgr
稯	zshw
燪	zshx
㷓	zshx
熧	zsih
㣭	zsiw
鑁	zsjw
鏓	zsjx
錝	zsjx
㯶	zsmw
糭	zsmw
骔	zsmx
㹅	zsnx
䁓	zsow
倊	zsrx
緃	zssr
縦	zssr
䍟	zssw
総	zssx
豵	zsur
碂	zsux
䝋	zsux
䑸	zsvx
翪	zsxw
㚇	zsxw
踨	zszr
䱣	zuau
䯿	zuau
葅	zucq
䔃	zucq
㵀	zudu
崪	zueu
㞺	zueu
稡	zuhu
卆	zuju
箤	zuvu
踿	zuzh
踤	zuzu
濢	zvdu
嶊	zvef
㠑	zvef
厜	zvii
蟕	zviy
錊	zvju
鋷	zvjy
嗺	zvkf
噿	zvku
栬	zvmb
檌	zvmf
䮔	zvmi
欈	zvmk
㰎	zvmv
䘹	zvpu
璻	zvwu
酔	zvyu
酻	zvyz
鷷	zybn
鶎	zybn
罇	zyfc
鐏	zyjc
㵵	zzdn
郰	zzee
棷	zzmy
齱	zzvy
